No.,Mid(100),Topic-M,T1,Topic-1,T2,Topic-2,T3,Topic-3,T4,Topic-4,T5,Topic-5,Tut (80),PCT (180),Comp(45),Comp(75),Comp(120),CT(300)
1,13,"K&K 2,3,4,6",0,"K&K 2,3",9,K&K 4,4,K&K 6,0,"A.P F 3,4",0,A.P F 5,18,31,6,0,6,37
2,35,"K&K 2,3,4,6",1,"K&K 2,3",11,K&K 4,15,K&K 6,0,"A.P F 3,4",3,A.P F 5,40,75,15,16,31,106
3,37,"K&K 2,3,4,6",15,"K&K 2,3",15,K&K 4,15,K&K 6,15,"A.P F 3,4",11,A.P F 5,80,117,11,5,16,133
4,13,"K&K 2,3,4,6",13,"K&K 2,3",11,K&K 4,15,K&K 6,11,"A.P F 3,4",15,A.P F 5,72,85,2,1,3,88
5,23,"K&K 2,3,4,6",5,"K&K 2,3",15,K&K 4,6,K&K 6,6,"A.P F 3,4",0,A.P F 5,43,66,14,7,21,87
6,9,"K&K 2,3,4,6",0,"K&K 2,3",2,K&K 4,0,K&K 6,0,"A.P F 3,4",0,A.P F 5,3,12,8,13,21,33
7,50,"K&K 2,3,4,6",15,"K&K 2,3",13,K&K 4,15,K&K 6,15,"A.P F 3,4",5,A.P F 5,78,128,12,7,19,147
8,32,"K&K 2,3,4,6",0,"K&K 2,3",15,K&K 4,2,K&K 6,0,"A.P F 3,4",15,A.P F 5,43,75,27,16,43,118
9,75,"K&K 2,3,4,6",0,"K&K 2,3",0,K&K 4,0,K&K 6,5,"A.P F 3,4",0,A.P F 5,7,82,15,5,20,102
10,56,"K&K 2,3,4,6",15,"K&K 2,3",3,K&K 4,8,K&K 6,12,"A.P F 3,4",14,A.P F 5,66,122,9,17,26,148
11,12,"K&K 2,3,4,6",5,"K&K 2,3",8,K&K 4,10,K&K 6,10,"A.P F 3,4",4,A.P F 5,44,56,8,7,15,71
12,49,"K&K 2,3,4,6",12,"K&K 2,3",15,K&K 4,8,K&K 6,15,"A.P F 3,4",3,A.P F 5,67,116,6,3,9,125
13,35,"K&K 2,3,4,6",14,"K&K 2,3",8,K&K 4,6,K&K 6,15,"A.P F 3,4",11,A.P F 5,64,99,6,11,17,116
14,42,"K&K 2,3,4,6",3,"K&K 2,3",6,K&K 4,15,K&K 6,15,"A.P F 3,4",9,A.P F 5,60,102,21,2,23,125
15,52,"K&K 2,3,4,6",13,"K&K 2,3",13,K&K 4,15,K&K 6,9,"A.P F 3,4",13,A.P F 5,72,124,7,12,19,143
16,60,"K&K 2,3,4,6",10,"K&K 2,3",15,K&K 4,14,K&K 6,15,"A.P F 3,4",11,A.P F 5,74,134,30,24,54,188
17,91,"K&K 2,3,4,6",14,"K&K 2,3",15,K&K 4,7,K&K 6,15,"A.P F 3,4",12,A.P F 5,75,166,33,25,58,224
18,40,"K&K 2,3,4,6",15,"K&K 2,3",15,K&K 4,15,K&K 6,0,"A.P F 3,4",15,A.P F 5,80,120,6,11,17,137
19,62,"K&K 2,3,4,6",7,"K&K 2,3",15,K&K 4,14,K&K 6,15,"A.P F 3,4",10,A.P F 5,72,134,35,37,72,206
20,46,"K&K 2,3,4,6",4,"K&K 2,3",9,K&K 4,8,K&K 6,3,"A.P F 3,4",0,A.P F 5,32,78,17,4,21,99
21,0,"K&K 2,3,4,6",0,"K&K 2,3",0,K&K 4,3,K&K 6,5,"A.P F 3,4",0,A.P F 5,11,11,3,1,4,15
22,0,"K&K 2,3,4,6",0,"K&K 2,3",0,K&K 4,0,K&K 6,0,"A.P F 3,4",0,A.P F 5,0,0,0,0,0,0
23,56,"K&K 2,3,4,6",11,"K&K 2,3",15,K&K 4,15,K&K 6,15,"A.P F 3,4",15,A.P F 5,80,136,28,13,41,177
24,42,"K&K 2,3,4,6",15,"K&K 2,3",15,K&K 4,0,K&K 6,1,"A.P F 3,4",0,A.P F 5,40,82,19,14,33,115
25,2,"K&K 2,3,4,6",0,"K&K 2,3",0,K&K 4,0,K&K 6,0,"A.P F 3,4",0,A.P F 5,0,2,0,0,0,2
26,32,"K&K 2,3,4,6",15,"K&K 2,3",15,K&K 4,15,K&K 6,0,"A.P F 3,4",15,A.P F 5,80,112,5,2,7,119
27,76,"K&K 2,3,4,6",4,"K&K 2,3",15,K&K 4,5,K&K 6,6,"A.P F 3,4",0,A.P F 5,40,116,37,19,56,172
28,18,"K&K 2,3,4,6",3,"K&K 2,3",15,K&K 4,11,K&K 6,13,"A.P F 3,4",15,A.P F 5,72,90,18,0,18,108
29,31,"K&K 2,3,4,6",5,"K&K 2,3",15,K&K 4,11,K&K 6,5,"A.P F 3,4",6,A.P F 5,50,81,11,6,17,98
30,36,"K&K 2,3,4,6",2,"K&K 2,3",15,K&K 4,15,K&K 6,4,"A.P F 3,4",15,A.P F 5,66,102,26,10,36,138
31,3,"K&K 2,3,4,6",0,"K&K 2,3",0,K&K 4,2,K&K 6,1,"A.P F 3,4",0,A.P F 5,4,7,0,0,0,7
32,90,"K&K 2,3,4,6",13,"K&K 2,3",15,K&K 4,12,K&K 6,15,"A.P F 3,4",15,A.P F 5,78,168,30,36,66,234
33,40,"K&K 2,3,4,6",6,"K&K 2,3",8,K&K 4,12,K&K 6,2,"A.P F 3,4",15,A.P F 5,55,95,14,2,16,111
34,72,"K&K 2,3,4,6",10,"K&K 2,3",3,K&K 4,12,K&K 6,11,"A.P F 3,4",9,A.P F 5,56,128,26,14,40,168
35,15,"K&K 2,3,4,6",0,"K&K 2,3",0,K&K 4,0,K&K 6,10,"A.P F 3,4",6,A.P F 5,22,37,2,0,2,39
36,31,"K&K 2,3,4,6",1,"K&K 2,3",8,K&K 4,7,K&K 6,4,"A.P F 3,4",12,A.P F 5,42,73,10,13,23,96
37,12,"K&K 2,3,4,6",8,"K&K 2,3",8,K&K 4,0,K&K 6,15,"A.P F 3,4",15,A.P F 5,62,74,13,2,15,89
38,51,"K&K 2,3,4,6",15,"K&K 2,3",5,K&K 4,15,K&K 6,9,"A.P F 3,4",1,A.P F 5,59,110,20,8,28,138
39,30,"K&K 2,3,4,6",10,"K&K 2,3",13,K&K 4,15,K&K 6,12,"A.P F 3,4",15,A.P F 5,74,104,20,19,39,143
40,49,"K&K 2,3,4,6",15,"K&K 2,3",8,K&K 4,8,K&K 6,13,"A.P F 3,4",15,A.P F 5,68,117,29,12,41,158
41,0,"K&K 2,3,4,6",0,"K&K 2,3",3,K&K 4,0,K&K 6,0,"A.P F 3,4",1,A.P F 5,6,6,15,2,17,23
42,56,"K&K 2,3,4,6",15,"K&K 2,3",15,K&K 4,0,K&K 6,15,"A.P F 3,4",12,A.P F 5,76,132,19,17,36,168
43,18,"K&K 2,3,4,6",1,"K&K 2,3",15,K&K 4,9,K&K 6,6,"A.P F 3,4",15,A.P F 5,60,78,13,4,17,95
44,33,"K&K 2,3,4,6",7,"K&K 2,3",0,K&K 4,1,K&K 6,1,"A.P F 3,4",0,A.P F 5,12,45,9,3,12,57
45,18,"K&K 2,3,4,6",14,"K&K 2,3",10,K&K 4,9,K&K 6,13,"A.P F 3,4",15,A.P F 5,70,88,3,0,3,91
46,8,"K&K 2,3,4,6",0,"K&K 2,3",3,K&K 4,3,K&K 6,0,"A.P F 3,4",0,A.P F 5,8,16,6,16,22,38
47,28,"K&K 2,3,4,6",0,"K&K 2,3",13,K&K 4,13,K&K 6,0,"A.P F 3,4",2,A.P F 5,38,66,9,7,16,82
48,41,"K&K 2,3,4,6",4,"K&K 2,3",6,K&K 4,0,K&K 6,0,"A.P F 3,4",8,A.P F 5,24,65,15,5,20,85
49,40,"K&K 2,3,4,6",1,"K&K 2,3",0,K&K 4,3,K&K 6,2,"A.P F 3,4",7,A.P F 5,17,57,16,12,28,85
50,56,"K&K 2,3,4,6",15,"K&K 2,3",10,K&K 4,15,K&K 6,5,"A.P F 3,4",15,A.P F 5,74,130,20,11,31,161
51,39,"K&K 2,3,4,6",1,"K&K 2,3",15,K&K 4,10,K&K 6,10,"A.P F 3,4",6,A.P F 5,54,93,22,9,31,124
52,17,"K&K 2,3,4,6",3,"K&K 2,3",5,K&K 4,14,K&K 6,6,"A.P F 3,4",1,A.P F 5,38,55,6,6,12,67
53,37,"K&K 2,3,4,6",12,"K&K 2,3",1,K&K 4,4,K&K 6,12,"A.P F 3,4",13,A.P F 5,55,92,17,8,25,117
54,13,"K&K 2,3,4,6",1,"K&K 2,3",11,K&K 4,7,K&K 6,5,"A.P F 3,4",0,A.P F 5,32,45,0,0,0,45
55,43,"K&K 2,3,4,6",12,"K&K 2,3",13,K&K 4,15,K&K 6,3,"A.P F 3,4",9,A.P F 5,66,109,18,23,41,150
56,5,"K&K 2,3,4,6",0,"K&K 2,3",5,K&K 4,2,K&K 6,1,"A.P F 3,4",7,A.P F 5,20,25,15,4,19,44
57,34,"K&K 2,3,4,6",15,"K&K 2,3",15,K&K 4,8,K&K 6,15,"A.P F 3,4",15,A.P F 5,80,114,13,14,27,141
58,47,"K&K 2,3,4,6",5,"K&K 2,3",0,K&K 4,14,K&K 6,0,"A.P F 3,4",7,A.P F 5,35,82,22,11,33,115
59,30,"K&K 2,3,4,6",2,"K&K 2,3",15,K&K 4,15,K&K 6,4,"A.P F 3,4",12,A.P F 5,62,92,25,10,35,127
60,35,"K&K 2,3,4,6",3,"K&K 2,3",7,K&K 4,10,K&K 6,9,"A.P F 3,4",12,A.P F 5,51,86,10,8,18,104
61,9,"K&K 2,3,4,6",3,"K&K 2,3",10,K&K 4,2,K&K 6,1,"A.P F 3,4",0,A.P F 5,22,31,1,0,1,32
62,32,"K&K 2,3,4,6",0,"K&K 2,3",13,K&K 4,15,K&K 6,15,"A.P F 3,4",14,A.P F 5,76,108,17,4,21,129
63,14,"K&K 2,3,4,6",0,"K&K 2,3",0,K&K 4,0,K&K 6,0,"A.P F 3,4",0,A.P F 5,0,14,9,3,12,26
64,61,"K&K 2,3,4,6",15,"K&K 2,3",15,K&K 4,10,K&K 6,15,"A.P F 3,4",8,A.P F 5,74,135,17,17,34,169
65,75,"K&K 2,3,4,6",10,"K&K 2,3",13,K&K 4,12,K&K 6,13,"A.P F 3,4",10,A.P F 5,64,139,21,10,31,170
66,43,"K&K 2,3,4,6",14,"K&K 2,3",14,K&K 4,5,K&K 6,6,"A.P F 3,4",2,A.P F 5,52,95,14,5,19,114
67,30,"K&K 2,3,4,6",1,"K&K 2,3",14,K&K 4,2,K&K 6,2,"A.P F 3,4",8,A.P F 5,35,65,3,5,8,73
68,29,"K&K 2,3,4,6",15,"K&K 2,3",15,K&K 4,11,K&K 6,15,"A.P F 3,4",14,A.P F 5,79,108,20,25,45,153
69,57,"K&K 2,3,4,6",6,"K&K 2,3",13,K&K 4,7,K&K 6,4,"A.P F 3,4",0,A.P F 5,40,97,32,51,83,180
70,31,"K&K 2,3,4,6",0,"K&K 2,3",0,K&K 4,0,K&K 6,0,"A.P F 3,4",0,A.P F 5,0,31,0,0,0,31
71,23,"K&K 2,3,4,6",2,"K&K 2,3",0,K&K 4,10,K&K 6,15,"A.P F 3,4",15,A.P F 5,56,79,3,4,7,86
72,80,"K&K 2,3,4,6",8,"K&K 2,3",15,K&K 4,3,K&K 6,15,"A.P F 3,4",4,A.P F 5,56,136,29,21,50,186
73,2,"K&K 2,3,4,6",0,"K&K 2,3",5,K&K 4,6,K&K 6,4,"A.P F 3,4",9,A.P F 5,32,34,5,3,8,42
74,28,"K&K 2,3,4,6",15,"K&K 2,3",15,K&K 4,15,K&K 6,4,"A.P F 3,4",12,A.P F 5,76,104,30,7,37,141
75,30,"K&K 2,3,4,6",10,"K&K 2,3",0,K&K 4,15,K&K 6,2,"A.P F 3,4",11,A.P F 5,51,81,6,5,11,92
76,14,"K&K 2,3,4,6",7,"K&K 2,3",13,K&K 4,15,K&K 6,3,"A.P F 3,4",15,A.P F 5,67,81,7,2,9,90
77,22,"K&K 2,3,4,6",12,"K&K 2,3",14,K&K 4,9,K&K 6,13,"A.P F 3,4",7,A.P F 5,64,86,12,3,15,101
78,18,"K&K 2,3,4,6",0,"K&K 2,3",7,K&K 4,4,K&K 6,1,"A.P F 3,4",11,A.P F 5,31,49,3,9,12,61
79,42,"K&K 2,3,4,6",9,"K&K 2,3",15,K&K 4,8,K&K 6,1,"A.P F 3,4",15,A.P F 5,63,105,8,0,8,113
80,67,"K&K 2,3,4,6",0,"K&K 2,3",0,K&K 4,2,K&K 6,15,"A.P F 3,4",15,A.P F 5,43,110,31,28,59,169
81,20,"K&K 2,3,4,6",0,"K&K 2,3",15,K&K 4,8,K&K 6,8,"A.P F 3,4",0,A.P F 5,42,62,2,12,14,76
82,9,"K&K 2,3,4,6",1,"K&K 2,3",0,K&K 4,2,K&K 6,0,"A.P F 3,4",0,A.P F 5,4,13,8,16,24,37
83,84,"K&K 2,3,4,6",0,"K&K 2,3",13,K&K 4,6,K&K 6,0,"A.P F 3,4",15,A.P F 5,46,130,9,9,18,148
84,38,"K&K 2,3,4,6",6,"K&K 2,3",4,K&K 4,9,K&K 6,6,"A.P F 3,4",12,A.P F 5,44,82,26,10,36,118
85,25,"K&K 2,3,4,6",15,"K&K 2,3",15,K&K 4,15,K&K 6,15,"A.P F 3,4",15,A.P F 5,80,105,14,3,17,122
86,11,"K&K 2,3,4,6",2,"K&K 2,3",0,K&K 4,6,K&K 6,2,"A.P F 3,4",1,A.P F 5,15,26,2,3,5,31
87,76,"K&K 2,3,4,6",15,"K&K 2,3",15,K&K 4,15,K&K 6,15,"A.P F 3,4",15,A.P F 5,80,156,31,16,47,203
88,46,"K&K 2,3,4,6",10,"K&K 2,3",15,K&K 4,15,K&K 6,4,"A.P F 3,4",15,A.P F 5,74,120,7,7,14,134
89,0,"K&K 2,3,4,6",4,"K&K 2,3",0,K&K 4,0,K&K 6,7,"A.P F 3,4",10,A.P F 5,28,28,0,0,0,28
90,9,"K&K 2,3,4,6",1,"K&K 2,3",10,K&K 4,15,K&K 6,2,"A.P F 3,4",12,A.P F 5,52,61,11,1,12,73
91,12,"K&K 2,3,4,6",4,"K&K 2,3",14,K&K 4,13,K&K 6,6,"A.P F 3,4",0,A.P F 5,50,62,8,0,8,70
92,76,"K&K 2,3,4,6",15,"K&K 2,3",15,K&K 4,8,K&K 6,1,"A.P F 3,4",12,A.P F 5,67,143,13,6,19,162
93,5,"K&K 2,3,4,6",9,"K&K 2,3",2,K&K 4,3,K&K 6,3,"A.P F 3,4",5,A.P F 5,27,32,8,7,15,47
94,92,"K&K 2,3,4,6",15,"K&K 2,3",15,K&K 4,15,K&K 6,15,"A.P F 3,4",0,A.P F 5,80,172,21,25,46,218
95,60,"K&K 2,3,4,6",15,"K&K 2,3",15,K&K 4,15,K&K 6,13,"A.P F 3,4",6,A.P F 5,78,138,33,17,50,188
96,22,"K&K 2,3,4,6",2,"K&K 2,3",10,K&K 4,11,K&K 6,7,"A.P F 3,4",15,A.P F 5,58,80,10,0,10,90
97,27,"K&K 2,3,4,6",2,"K&K 2,3",15,K&K 4,15,K&K 6,5,"A.P F 3,4",15,A.P F 5,67,94,23,8,31,125
98,21,"K&K 2,3,4,6",2,"K&K 2,3",9,K&K 4,2,K&K 6,4,"A.P F 3,4",12,A.P F 5,36,57,8,12,20,77
99,17,"K&K 2,3,4,6",0,"K&K 2,3",11,K&K 4,5,K&K 6,9,"A.P F 3,4",0,A.P F 5,34,51,8,0,8,59
100,32,"K&K 2,3,4,6",14,"K&K 2,3",15,K&K 4,15,K&K 6,15,"A.P F 3,4",15,A.P F 5,80,112,31,11,42,154
101,9,"K&K 2,3,4,6",8,"K&K 2,3",12,K&K 4,5,K&K 6,1,"A.P F 3,4",7,A.P F 5,43,52,3,0,3,55
102,100,"K&K 2,3,4,6",15,"K&K 2,3",14,K&K 4,14,K&K 6,15,"A.P F 3,4",14,A.P F 5,78,178,44,61,105,283
103,72,"K&K 2,3,4,6",15,"K&K 2,3",14,K&K 4,15,K&K 6,11,"A.P F 3,4",15,A.P F 5,79,151,20,7,27,178
104,17,"K&K 2,3,4,6",4,"K&K 2,3",1,K&K 4,4,K&K 6,1,"A.P F 3,4",7,A.P F 5,22,39,5,3,8,47
105,33,"K&K 2,3,4,6",0,"K&K 2,3",15,K&K 4,15,K&K 6,2,"A.P F 3,4",15,A.P F 5,63,96,10,5,15,111
106,15,"K&K 2,3,4,6",0,"K&K 2,3",2,K&K 4,0,K&K 6,10,"A.P F 3,4",0,A.P F 5,16,31,3,3,6,37
107,20,"K&K 2,3,4,6",15,"K&K 2,3",0,K&K 4,5,K&K 6,5,"A.P F 3,4",9,A.P F 5,46,66,13,2,15,81
108,41,"K&K 2,3,4,6",7,"K&K 2,3",15,K&K 4,6,K&K 6,6,"A.P F 3,4",9,A.P F 5,50,91,23,25,48,139
109,20,"K&K 2,3,4,6",0,"K&K 2,3",3,K&K 4,4,K&K 6,0,"A.P F 3,4",0,A.P F 5,10,30,5,0,5,35
110,52,"K&K 2,3,4,6",15,"K&K 2,3",15,K&K 4,15,K&K 6,5,"A.P F 3,4",13,A.P F 5,78,130,23,18,41,171
111,8,"K&K 2,3,4,6",0,"K&K 2,3",1,K&K 4,6,K&K 6,4,"A.P F 3,4",0,A.P F 5,15,23,2,0,2,25
112,37,"K&K 2,3,4,6",2,"K&K 2,3",7,K&K 4,12,K&K 6,1,"A.P F 3,4",2,A.P F 5,31,68,16,9,25,93
113,34,"K&K 2,3,4,6",8,"K&K 2,3",15,K&K 4,15,K&K 6,0,"A.P F 3,4",12,A.P F 5,67,101,13,17,30,131
114,22,"K&K 2,3,4,6",12,"K&K 2,3",10,K&K 4,15,K&K 6,3,"A.P F 3,4",1,A.P F 5,54,76,20,3,23,99
115,33,"K&K 2,3,4,6",7,"K&K 2,3",15,K&K 4,12,K&K 6,6,"A.P F 3,4",15,A.P F 5,66,99,14,22,36,135
116,86,"K&K 2,3,4,6",12,"K&K 2,3",15,K&K 4,15,K&K 6,1,"A.P F 3,4",15,A.P F 5,76,162,24,28,52,214
117,12,"K&K 2,3,4,6",2,"K&K 2,3",8,K&K 4,3,K&K 6,2,"A.P F 3,4",1,A.P F 5,20,32,0,3,3,35
118,27,"K&K 2,3,4,6",11,"K&K 2,3",10,K&K 4,7,K&K 6,1,"A.P F 3,4",0,A.P F 5,39,66,6,5,11,77
119,58,"K&K 2,3,4,6",0,"K&K 2,3",11,K&K 4,15,K&K 6,8,"A.P F 3,4",13,A.P F 5,63,121,20,22,42,163
120,34,"K&K 2,3,4,6",0,"K&K 2,3",13,K&K 4,15,K&K 6,7,"A.P F 3,4",15,A.P F 5,67,101,21,0,21,122
121,42,"K&K 2,3,4,6",15,"K&K 2,3",15,K&K 4,15,K&K 6,11,"A.P F 3,4",15,A.P F 5,80,122,18,7,25,147
122,15,"K&K 2,3,4,6",0,"K&K 2,3",8,K&K 4,15,K&K 6,3,"A.P F 3,4",9,A.P F 5,47,62,10,10,20,82
123,39,"K&K 2,3,4,6",9,"K&K 2,3",0,K&K 4,1,K&K 6,15,"A.P F 3,4",9,A.P F 5,46,85,18,16,34,119
124,26,"K&K 2,3,4,6",5,"K&K 2,3",15,K&K 4,0,K&K 6,2,"A.P F 3,4",0,A.P F 5,30,56,13,4,17,73
125,0,"K&K 2,3,4,6",0,"K&K 2,3",0,K&K 4,3,K&K 6,0,"A.P F 3,4",3,A.P F 5,8,8,3,2,5,13
126,53,"K&K 2,3,4,6",1,"K&K 2,3",13,K&K 4,12,K&K 6,13,"A.P F 3,4",12,A.P F 5,67,120,11,7,18,138
127,36,"K&K 2,3,4,6",0,"K&K 2,3",0,K&K 4,2,K&K 6,4,"A.P F 3,4",10,A.P F 5,22,58,12,11,23,81
128,20,"K&K 2,3,4,6",1,"K&K 2,3",8,K&K 4,8,K&K 6,6,"A.P F 3,4",4,A.P F 5,35,55,5,2,7,62
129,5,"K&K 2,3,4,6",1,"K&K 2,3",0,K&K 4,4,K&K 6,3,"A.P F 3,4",12,A.P F 5,27,32,3,0,3,35
130,26,"K&K 2,3,4,6",1,"K&K 2,3",15,K&K 4,15,K&K 6,7,"A.P F 3,4",6,A.P F 5,58,84,17,14,31,115
131,11,"K&K 2,3,4,6",4,"K&K 2,3",0,K&K 4,4,K&K 6,6,"A.P F 3,4",5,A.P F 5,26,37,3,4,7,44
132,61,"K&K 2,3,4,6",10,"K&K 2,3",14,K&K 4,6,K&K 6,12,"A.P F 3,4",15,A.P F 5,68,129,23,7,30,159
133,8,"K&K 2,3,4,6",1,"K&K 2,3",0,K&K 4,2,K&K 6,1,"A.P F 3,4",3,A.P F 5,10,18,5,6,11,29
134,20,"K&K 2,3,4,6",9,"K&K 2,3",15,K&K 4,5,K&K 6,14,"A.P F 3,4",9,A.P F 5,63,83,3,4,7,90
135,12,"K&K 2,3,4,6",5,"K&K 2,3",10,K&K 4,4,K&K 6,4,"A.P F 3,4",11,A.P F 5,40,52,4,2,6,58
136,34,"K&K 2,3,4,6",0,"K&K 2,3",11,K&K 4,3,K&K 6,0,"A.P F 3,4",13,A.P F 5,36,70,3,12,15,85
137,47,"K&K 2,3,4,6",13,"K&K 2,3",15,K&K 4,15,K&K 6,10,"A.P F 3,4",15,A.P F 5,78,125,14,7,21,146
138,3,"K&K 2,3,4,6",11,"K&K 2,3",14,K&K 4,4,K&K 6,0,"A.P F 3,4",5,A.P F 5,46,49,0,0,0,49
139,50,"K&K 2,3,4,6",9,"K&K 2,3",15,K&K 4,2,K&K 6,15,"A.P F 3,4",15,A.P F 5,72,122,14,20,34,156
140,4,"K&K 2,3,4,6",0,"K&K 2,3",0,K&K 4,4,K&K 6,4,"A.P F 3,4",1,A.P F 5,12,16,3,2,5,21
141,45,"K&K 2,3,4,6",15,"K&K 2,3",15,K&K 4,5,K&K 6,5,"A.P F 3,4",1,A.P F 5,54,99,13,2,15,114
142,69,"K&K 2,3,4,6",5,"K&K 2,3",15,K&K 4,15,K&K 6,15,"A.P F 3,4",12,A.P F 5,76,145,26,21,47,192
143,0,"K&K 2,3,4,6",0,"K&K 2,3",0,K&K 4,0,K&K 6,0,"A.P F 3,4",0,A.P F 5,0,0,0,0,0,0
144,49,"K&K 2,3,4,6",0,"K&K 2,3",5,K&K 4,0,K&K 6,15,"A.P F 3,4",0,A.P F 5,27,76,11,5,16,92
145,52,"K&K 2,3,4,6",6,"K&K 2,3",2,K&K 4,14,K&K 6,1,"A.P F 3,4",1,A.P F 5,31,83,7,10,17,100
146,5,"K&K 2,3,4,6",2,"K&K 2,3",0,K&K 4,1,K&K 6,2,"A.P F 3,4",2,A.P F 5,10,15,2,0,2,17
147,43,"K&K 2,3,4,6",0,"K&K 2,3",0,K&K 4,9,K&K 6,0,"A.P F 3,4",0,A.P F 5,12,55,0,0,0,55
148,5,"K&K 2,3,4,6",15,"K&K 2,3",13,K&K 4,10,K&K 6,9,"A.P F 3,4",4,A.P F 5,63,68,2,2,4,72
149,29,"K&K 2,3,4,6",15,"K&K 2,3",12,K&K 4,15,K&K 6,15,"A.P F 3,4",15,A.P F 5,80,109,11,5,16,125
150,2,"K&K 2,3,4,6",10,"K&K 2,3",5,K&K 4,4,K&K 6,1,"A.P F 3,4",12,A.P F 5,42,44,2,0,2,46
151,14,"K&K 2,3,4,6",11,"K&K 2,3",0,K&K 4,8,K&K 6,4,"A.P F 3,4",4,A.P F 5,36,50,21,10,31,81
152,27,"K&K 2,3,4,6",4,"K&K 2,3",0,K&K 4,4,K&K 6,6,"A.P F 3,4",0,A.P F 5,19,46,0,0,0,46
153,12,"K&K 2,3,4,6",12,"K&K 2,3",12,K&K 4,7,K&K 6,15,"A.P F 3,4",0,A.P F 5,62,74,6,0,6,80
154,69,"K&K 2,3,4,6",0,"K&K 2,3",5,K&K 4,0,K&K 6,2,"A.P F 3,4",15,A.P F 5,30,99,27,19,46,145
155,0,"K&K 2,3,4,6",0,"K&K 2,3",0,K&K 4,0,K&K 6,0,"A.P F 3,4",2,A.P F 5,3,3,5,0,5,8
156,18,"K&K 2,3,4,6",4,"K&K 2,3",12,K&K 4,3,K&K 6,4,"A.P F 3,4",0,A.P F 5,31,49,14,4,18,67
157,13,"K&K 2,3,4,6",0,"K&K 2,3",8,K&K 4,4,K&K 6,1,"A.P F 3,4",3,A.P F 5,21,34,8,2,10,44
158,9,"K&K 2,3,4,6",0,"K&K 2,3",0,K&K 4,6,K&K 6,0,"A.P F 3,4",0,A.P F 5,8,17,0,1,1,18
159,2,"K&K 2,3,4,6",0,"K&K 2,3",15,K&K 4,12,K&K 6,0,"A.P F 3,4",14,A.P F 5,55,57,0,0,0,57
160,17,"K&K 2,3,4,6",1,"K&K 2,3",0,K&K 4,0,K&K 6,0,"A.P F 3,4",0,A.P F 5,2,19,0,0,0,19
161,39,"K&K 2,3,4,6",8,"K&K 2,3",15,K&K 4,5,K&K 6,4,"A.P F 3,4",1,A.P F 5,43,82,20,13,33,115
162,58,"K&K 2,3,4,6",0,"K&K 2,3",7,K&K 4,8,K&K 6,14,"A.P F 3,4",7,A.P F 5,48,106,28,9,37,143
163,85,"K&K 2,3,4,6",15,"K&K 2,3",15,K&K 4,7,K&K 6,15,"A.P F 3,4",13,A.P F 5,78,163,20,22,42,205
164,29,"K&K 2,3,4,6",10,"K&K 2,3",15,K&K 4,15,K&K 6,15,"A.P F 3,4",10,A.P F 5,74,103,9,6,15,118
165,13,"K&K 2,3,4,6",1,"K&K 2,3",0,K&K 4,0,K&K 6,2,"A.P F 3,4",0,A.P F 5,4,17,10,5,15,32
166,45,"K&K 2,3,4,6",10,"K&K 2,3",15,K&K 4,15,K&K 6,15,"A.P F 3,4",15,A.P F 5,80,125,21,7,28,153
167,33,"K&K 2,3,4,6",0,"K&K 2,3",15,K&K 4,6,K&K 6,15,"A.P F 3,4",13,A.P F 5,66,99,24,14,38,137
168,17,"K&K 2,3,4,6",0,"K&K 2,3",15,K&K 4,15,K&K 6,4,"A.P F 3,4",0,A.P F 5,46,63,5,6,11,74
169,0,"K&K 2,3,4,6",0,"K&K 2,3",11,K&K 4,15,K&K 6,4,"A.P F 3,4",11,A.P F 5,55,55,21,2,23,78
170,7,"K&K 2,3,4,6",0,"K&K 2,3",13,K&K 4,6,K&K 6,7,"A.P F 3,4",6,A.P F 5,43,50,1,0,1,51
171,5,"K&K 2,3,4,6",0,"K&K 2,3",0,K&K 4,3,K&K 6,4,"A.P F 3,4",7,A.P F 5,19,24,3,0,3,27
172,37,"K&K 2,3,4,6",4,"K&K 2,3",14,K&K 4,15,K&K 6,15,"A.P F 3,4",15,A.P F 5,79,116,26,11,37,153
173,2,"K&K 2,3,4,6",0,"K&K 2,3",0,K&K 4,0,K&K 6,0,"A.P F 3,4",0,A.P F 5,0,2,5,0,5,7
174,5,"K&K 2,3,4,6",0,"K&K 2,3",0,K&K 4,0,K&K 6,1,"A.P F 3,4",0,A.P F 5,2,7,0,0,0,7
175,69,"K&K 2,3,4,6",12,"K&K 2,3",15,K&K 4,11,K&K 6,5,"A.P F 3,4",8,A.P F 5,62,131,17,11,28,159
176,34,"K&K 2,3,4,6",6,"K&K 2,3",8,K&K 4,5,K&K 6,15,"A.P F 3,4",11,A.P F 5,54,88,21,7,28,116
177,21,"K&K 2,3,4,6",6,"K&K 2,3",3,K&K 4,4,K&K 6,3,"A.P F 3,4",0,A.P F 5,22,43,16,3,19,62
178,23,"K&K 2,3,4,6",0,"K&K 2,3",4,K&K 4,13,K&K 6,3,"A.P F 3,4",5,A.P F 5,34,57,3,0,3,60
179,18,"K&K 2,3,4,6",0,"K&K 2,3",4,K&K 4,0,K&K 6,6,"A.P F 3,4",15,A.P F 5,34,52,7,3,10,62
180,18,"K&K 2,3,4,6",15,"K&K 2,3",15,K&K 4,0,K&K 6,15,"A.P F 3,4",12,A.P F 5,76,94,10,10,20,114
181,0,"K&K 2,3,4,6",0,"K&K 2,3",0,K&K 4,0,K&K 6,0,"A.P F 3,4",0,A.P F 5,0,0,0,0,0,0
182,43,"K&K 2,3,4,6",0,"K&K 2,3",15,K&K 4,0,K&K 6,0,"A.P F 3,4",13,A.P F 5,38,81,25,23,48,129
183,6,"K&K 2,3,4,6",0,"K&K 2,3",15,K&K 4,0,K&K 6,4,"A.P F 3,4",0,A.P F 5,26,32,5,0,5,37
184,13,"K&K 2,3,4,6",9,"K&K 2,3",15,K&K 4,0,K&K 6,0,"A.P F 3,4",10,A.P F 5,46,59,10,0,10,69
185,0,"K&K 2,3,4,6",0,"K&K 2,3",5,K&K 4,0,K&K 6,11,"A.P F 3,4",0,A.P F 5,22,22,3,1,4,26
186,14,"K&K 2,3,4,6",1,"K&K 2,3",0,K&K 4,0,K&K 6,0,"A.P F 3,4",0,A.P F 5,1,15,0,0,0,15
187,56,"K&K 2,3,4,6",12,"K&K 2,3",8,K&K 4,5,K&K 6,15,"A.P F 3,4",5,A.P F 5,54,110,15,22,37,147
188,11,"K&K 2,3,4,6",12,"K&K 2,3",10,K&K 4,10,K&K 6,1,"A.P F 3,4",11,A.P F 5,58,69,18,0,18,87
189,8,"K&K 2,3,4,6",8,"K&K 2,3",0,K&K 4,5,K&K 6,0,"A.P F 3,4",3,A.P F 5,22,30,3,4,7,37
190,48,"K&K 2,3,4,6",9,"K&K 2,3",15,K&K 4,6,K&K 6,15,"A.P F 3,4",2,A.P F 5,60,108,12,3,15,123
191,46,"K&K 2,3,4,6",6,"K&K 2,3",15,K&K 4,9,K&K 6,15,"A.P F 3,4",15,A.P F 5,72,118,24,16,40,158
192,52,"K&K 2,3,4,6",13,"K&K 2,3",11,K&K 4,14,K&K 6,0,"A.P F 3,4",11,A.P F 5,66,118,29,8,37,155
193,15,"K&K 2,3,4,6",14,"K&K 2,3",,K&K 4,15,K&K 6,5,"A.P F 3,4",15,A.P F 5,59,74,3,2,5,79
194,19,"K&K 2,3,4,6",0,"K&K 2,3",2,K&K 4,0,K&K 6,0,"A.P F 3,4",0,A.P F 5,3,22,8,2,10,32
195,32,"K&K 2,3,4,6",0,"K&K 2,3",15,K&K 4,5,K&K 6,15,"A.P F 3,4",15,A.P F 5,67,99,10,6,16,115
196,12,"K&K 2,3,4,6",13,"K&K 2,3",3,K&K 4,6,K&K 6,13,"A.P F 3,4",15,A.P F 5,63,75,16,19,35,110
197,29,"K&K 2,3,4,6",12,"K&K 2,3",15,K&K 4,13,K&K 6,13,"A.P F 3,4",13,A.P F 5,72,101,22,7,29,130
198,1,"K&K 2,3,4,6",2,"K&K 2,3",11,K&K 4,0,K&K 6,7,"A.P F 3,4",15,A.P F 5,47,48,9,0,9,57
199,24,"K&K 2,3,4,6",1,"K&K 2,3",8,K&K 4,4,K&K 6,1,"A.P F 3,4",0,A.P F 5,19,43,3,0,3,46
200,36,"K&K 2,3,4,6",0,"K&K 2,3",15,K&K 4,10,K&K 6,10,"A.P F 3,4",13,A.P F 5,64,100,13,6,19,119
201,9,"K&K 2,3,4,6",0,"K&K 2,3",10,K&K 4,7,K&K 6,10,"A.P F 3,4",4,A.P F 5,42,51,0,0,0,51
202,18,"K&K 2,3,4,6",4,"K&K 2,3",2,K&K 4,12,K&K 6,5,"A.P F 3,4",10,A.P F 5,42,60,5,2,7,67
203,34,"K&K 2,3,4,6",13,"K&K 2,3",15,K&K 4,15,K&K 6,4,"A.P F 3,4",12,A.P F 5,74,108,12,11,23,131
204,62,"K&K 2,3,4,6",0,"K&K 2,3",0,K&K 4,5,K&K 6,1,"A.P F 3,4",0,A.P F 5,8,70,21,7,28,98
205,15,"K&K 2,3,4,6",6,"K&K 2,3",0,K&K 4,0,K&K 6,1,"A.P F 3,4",0,A.P F 5,10,25,6,0,6,31
206,13,"K&K 2,3,4,6",0,"K&K 2,3",15,K&K 4,2,K&K 6,4,"A.P F 3,4",12,A.P F 5,44,57,15,8,23,80
207,7,"K&K 2,3,4,6",7,"K&K 2,3",5,K&K 4,0,K&K 6,4,"A.P F 3,4",1,A.P F 5,23,30,3,1,4,34
208,50,"K&K 2,3,4,6",12,"K&K 2,3",15,K&K 4,8,K&K 6,2,"A.P F 3,4",14,A.P F 5,66,116,18,8,26,142
209,11,"K&K 2,3,4,6",2,"K&K 2,3",2,K&K 4,1,K&K 6,5,"A.P F 3,4",11,A.P F 5,27,38,16,7,23,61
210,23,"K&K 2,3,4,6",2,"K&K 2,3",3,K&K 4,5,K&K 6,11,"A.P F 3,4",7,A.P F 5,35,58,4,5,9,67
211,48,"K&K 2,3,4,6",6,"K&K 2,3",15,K&K 4,15,K&K 6,15,"A.P F 3,4",12,A.P F 5,76,124,12,7,19,143
212,8,"K&K 2,3,4,6",7,"K&K 2,3",12,K&K 4,3,K&K 6,3,"A.P F 3,4",4,A.P F 5,35,43,0,2,2,45
213,71,"K&K 2,3,4,6",15,"K&K 2,3",14,K&K 4,7,K&K 6,15,"A.P F 3,4",9,A.P F 5,71,142,22,17,39,181
214,71,"K&K 2,3,4,6",9,"K&K 2,3",15,K&K 4,15,K&K 6,4,"A.P F 3,4",6,A.P F 5,60,131,22,29,51,182
215,36,"K&K 2,3,4,6",3,"K&K 2,3",8,K&K 4,1,K&K 6,9,"A.P F 3,4",11,A.P F 5,42,78,6,12,18,96
216,30,"K&K 2,3,4,6",5,"K&K 2,3",15,K&K 4,4,K&K 6,7,"A.P F 3,4",4,A.P F 5,42,72,8,2,10,82
217,11,"K&K 2,3,4,6",15,"K&K 2,3",15,K&K 4,2,K&K 6,4,"A.P F 3,4",12,A.P F 5,62,73,17,3,20,93
218,72,"K&K 2,3,4,6",7,"K&K 2,3",15,K&K 4,14,K&K 6,6,"A.P F 3,4",3,A.P F 5,56,128,22,13,35,163
219,38,"K&K 2,3,4,6",1,"K&K 2,3",15,K&K 4,0,K&K 6,0,"A.P F 3,4",12,A.P F 5,38,76,8,10,18,94
220,2,"K&K 2,3,4,6",2,"K&K 2,3",3,K&K 4,3,K&K 6,3,"A.P F 3,4",15,A.P F 5,32,34,6,0,6,40
221,37,"K&K 2,3,4,6",14,"K&K 2,3",0,K&K 4,0,K&K 6,8,"A.P F 3,4",10,A.P F 5,43,80,26,5,31,111
222,44,"K&K 2,3,4,6",13,"K&K 2,3",15,K&K 4,15,K&K 6,1,"A.P F 3,4",15,A.P F 5,78,122,21,18,39,161
223,10,"K&K 2,3,4,6",0,"K&K 2,3",0,K&K 4,0,K&K 6,1,"A.P F 3,4",0,A.P F 5,2,12,6,5,11,23
224,43,"K&K 2,3,4,6",9,"K&K 2,3",11,K&K 4,15,K&K 6,7,"A.P F 3,4",15,A.P F 5,67,110,8,13,21,131
225,27,"K&K 2,3,4,6",5,"K&K 2,3",11,K&K 4,3,K&K 6,5,"A.P F 3,4",8,A.P F 5,39,66,14,5,19,85
226,24,"K&K 2,3,4,6",1,"K&K 2,3",15,K&K 4,12,K&K 6,0,"A.P F 3,4",11,A.P F 5,52,76,4,6,10,86
227,38,"K&K 2,3,4,6",15,"K&K 2,3",15,K&K 4,15,K&K 6,0,"A.P F 3,4",15,A.P F 5,80,118,36,19,55,173
228,33,"K&K 2,3,4,6",3,"K&K 2,3",15,K&K 4,15,K&K 6,15,"A.P F 3,4",15,A.P F 5,80,113,21,5,26,139
229,14,"K&K 2,3,4,6",0,"K&K 2,3",15,K&K 4,6,K&K 6,0,"A.P F 3,4",15,A.P F 5,48,62,11,2,13,75
230,6,"K&K 2,3,4,6",6,"K&K 2,3",11,K&K 4,15,K&K 6,15,"A.P F 3,4",0,A.P F 5,63,69,0,5,5,74
231,3,"K&K 2,3,4,6",0,"K&K 2,3",7,K&K 4,4,K&K 6,0,"A.P F 3,4",1,A.P F 5,16,19,5,0,5,24
232,34,"K&K 2,3,4,6",11,"K&K 2,3",15,K&K 4,11,K&K 6,1,"A.P F 3,4",15,A.P F 5,70,104,19,10,29,133
233,3,"K&K 2,3,4,6",8,"K&K 2,3",15,K&K 4,12,K&K 6,12,"A.P F 3,4",5,A.P F 5,63,66,11,0,11,77
234,28,"K&K 2,3,4,6",4,"K&K 2,3",14,K&K 4,5,K&K 6,14,"A.P F 3,4",8,A.P F 5,54,82,9,2,11,93
235,29,"K&K 2,3,4,6",0,"K&K 2,3",0,K&K 4,2,K&K 6,3,"A.P F 3,4",8,A.P F 5,18,47,11,4,15,62
236,6,"K&K 2,3,4,6",0,"K&K 2,3",15,K&K 4,10,K&K 6,0,"A.P F 3,4",14,A.P F 5,52,58,0,3,3,61
237,23,"K&K 2,3,4,6",0,"K&K 2,3",1,K&K 4,4,K&K 6,5,"A.P F 3,4",1,A.P F 5,15,38,13,11,24,62
238,62,"K&K 2,3,4,6",15,"K&K 2,3",15,K&K 4,15,K&K 6,15,"A.P F 3,4",13,A.P F 5,80,142,25,10,35,177
239,4,"K&K 2,3,4,6",2,"K&K 2,3",6,K&K 4,4,K&K 6,0,"A.P F 3,4",0,A.P F 5,16,20,11,5,16,36
240,34,"K&K 2,3,4,6",11,"K&K 2,3",15,K&K 4,0,K&K 6,15,"A.P F 3,4",15,A.P F 5,75,109,21,13,34,143
241,63,"K&K 2,3,4,6",12,"K&K 2,3",13,K&K 4,15,K&K 6,15,"A.P F 3,4",15,A.P F 5,78,141,35,33,68,209
242,24,"K&K 2,3,4,6",5,"K&K 2,3",12,K&K 4,11,K&K 6,6,"A.P F 3,4",3,A.P F 5,46,70,26,25,51,121
243,30,"K&K 2,3,4,6",7,"K&K 2,3",3,K&K 4,15,K&K 6,13,"A.P F 3,4",11,A.P F 5,62,92,15,16,31,123
244,56,"K&K 2,3,4,6",5,"K&K 2,3",15,K&K 4,10,K&K 6,12,"A.P F 3,4",14,A.P F 5,68,124,11,21,32,156
245,14,"K&K 2,3,4,6",0,"K&K 2,3",15,K&K 4,6,K&K 6,0,"A.P F 3,4",13,A.P F 5,46,60,8,1,9,69
246,9,"K&K 2,3,4,6",0,"K&K 2,3",15,K&K 4,0,K&K 6,4,"A.P F 3,4",15,A.P F 5,46,55,13,0,13,68
247,2,"K&K 2,3,4,6",1,"K&K 2,3",1,K&K 4,15,K&K 6,0,"A.P F 3,4",0,A.P F 5,23,25,3,3,6,31
248,40,"K&K 2,3,4,6",11,"K&K 2,3",15,K&K 4,5,K&K 6,15,"A.P F 3,4",15,A.P F 5,75,115,14,14,28,143
249,3,"K&K 2,3,4,6",0,"K&K 2,3",2,K&K 4,2,K&K 6,0,"A.P F 3,4",4,A.P F 5,11,14,3,4,7,21
250,78,"K&K 2,3,4,6",15,"K&K 2,3",15,K&K 4,15,K&K 6,15,"A.P F 3,4",15,A.P F 5,80,158,30,20,50,208
251,35,"K&K 2,3,4,6",3,"K&K 2,3",15,K&K 4,10,K&K 6,12,"A.P F 3,4",3,A.P F 5,54,89,15,7,22,111
252,7,"K&K 2,3,4,6",0,"K&K 2,3",0,K&K 4,0,K&K 6,0,"A.P F 3,4",8,A.P F 5,11,18,5,0,5,23
253,16,"K&K 2,3,4,6",5,"K&K 2,3",6,K&K 4,6,K&K 6,1,"A.P F 3,4",12,A.P F 5,39,55,12,11,23,78
254,19,"K&K 2,3,4,6",4,"K&K 2,3",5,K&K 4,10,K&K 6,4,"A.P F 3,4",12,A.P F 5,42,61,19,7,26,87
255,65,"K&K 2,3,4,6",15,"K&K 2,3",15,K&K 4,2,K&K 6,15,"A.P F 3,4",13,A.P F 5,78,143,42,7,49,192
256,2,"K&K 2,3,4,6",1,"K&K 2,3",7,K&K 4,1,K&K 6,2,"A.P F 3,4",8,A.P F 5,24,26,6,0,6,32
257,36,"K&K 2,3,4,6",14,"K&K 2,3",5,K&K 4,15,K&K 6,15,"A.P F 3,4",15,A.P F 5,79,115,29,18,47,162
258,0,"K&K 2,3,4,6",0,"K&K 2,3",1,K&K 4,2,K&K 6,1,"A.P F 3,4",1,A.P F 5,7,7,0,3,3,10
259,14,"K&K 2,3,4,6",0,"K&K 2,3",0,K&K 4,0,K&K 6,0,"A.P F 3,4",0,A.P F 5,0,14,3,2,5,19
260,52,"K&K 2,3,4,6",14,"K&K 2,3",15,K&K 4,0,K&K 6,0,"A.P F 3,4",10,A.P F 5,52,104,12,10,22,126
261,14,"K&K 2,3,4,6",0,"K&K 2,3",5,K&K 4,2,K&K 6,0,"A.P F 3,4",10,A.P F 5,23,37,16,5,21,58
262,48,"K&K 2,3,4,6",3,"K&K 2,3",8,K&K 4,0,K&K 6,3,"A.P F 3,4",15,A.P F 5,39,87,9,9,18,105
263,6,"K&K 2,3,4,6",8,"K&K 2,3",0,K&K 4,12,K&K 6,4,"A.P F 3,4",5,A.P F 5,39,45,14,13,27,72
264,42,"K&K 2,3,4,6",14,"K&K 2,3",15,K&K 4,2,K&K 6,4,"A.P F 3,4",15,A.P F 5,64,106,18,8,26,132
265,29,"K&K 2,3,4,6",0,"K&K 2,3",15,K&K 4,15,K&K 6,1,"A.P F 3,4",15,A.P F 5,62,91,19,10,29,120
266,80,"K&K 2,3,4,6",15,"K&K 2,3",2,K&K 4,10,K&K 6,15,"A.P F 3,4",9,A.P F 5,66,146,29,18,47,193
267,17,"K&K 2,3,4,6",1,"K&K 2,3",10,K&K 4,9,K&K 6,0,"A.P F 3,4",3,A.P F 5,31,48,3,3,6,54
268,38,"K&K 2,3,4,6",11,"K&K 2,3",0,K&K 4,0,K&K 6,1,"A.P F 3,4",0,A.P F 5,16,54,14,1,15,69
269,43,"K&K 2,3,4,6",4,"K&K 2,3",0,K&K 4,6,K&K 6,0,"A.P F 3,4",15,A.P F 5,34,77,15,8,23,100
270,31,"K&K 2,3,4,6",4,"K&K 2,3",7,K&K 4,0,K&K 6,0,"A.P F 3,4",6,A.P F 5,23,54,6,2,8,62
271,22,"K&K 2,3,4,6",1,"K&K 2,3",0,K&K 4,9,K&K 6,0,"A.P F 3,4",2,A.P F 5,16,38,0,0,0,38
272,48,"K&K 2,3,4,6",11,"K&K 2,3",13,K&K 4,8,K&K 6,4,"A.P F 3,4",0,A.P F 5,48,96,15,6,21,117
273,5,"K&K 2,3,4,6",1,"K&K 2,3",1,K&K 4,1,K&K 6,1,"A.P F 3,4",0,A.P F 5,6,11,3,0,3,14
274,43,"K&K 2,3,4,6",2,"K&K 2,3",3,K&K 4,4,K&K 6,10,"A.P F 3,4",8,A.P F 5,34,77,3,6,9,86
275,5,"K&K 2,3,4,6",10,"K&K 2,3",7,K&K 4,12,K&K 6,0,"A.P F 3,4",7,A.P F 5,48,53,2,0,2,55
276,48,"K&K 2,3,4,6",0,"K&K 2,3",13,K&K 4,15,K&K 6,5,"A.P F 3,4",4,A.P F 5,50,98,17,20,37,135
277,16,"K&K 2,3,4,6",14,"K&K 2,3",15,K&K 4,15,K&K 6,4,"A.P F 3,4",12,A.P F 5,75,91,18,12,30,121
278,49,"K&K 2,3,4,6",0,"K&K 2,3",15,K&K 4,5,K&K 6,11,"A.P F 3,4",15,A.P F 5,62,111,25,11,36,147
279,55,"K&K 2,3,4,6",13,"K&K 2,3",15,K&K 4,15,K&K 6,15,"A.P F 3,4",11,A.P F 5,78,133,36,11,47,180
280,5,"K&K 2,3,4,6",0,"K&K 2,3",4,K&K 4,0,K&K 6,1,"A.P F 3,4",0,A.P F 5,7,12,0,3,3,15
281,39,"K&K 2,3,4,6",8,"K&K 2,3",15,K&K 4,15,K&K 6,15,"A.P F 3,4",15,A.P F 5,80,119,15,32,47,166
282,66,"K&K 2,3,4,6",0,"K&K 2,3",15,K&K 4,15,K&K 6,11,"A.P F 3,4",15,A.P F 5,75,141,24,6,30,171
283,26,"K&K 2,3,4,6",1,"K&K 2,3",10,K&K 4,15,K&K 6,1,"A.P F 3,4",12,A.P F 5,51,77,22,10,32,109
284,29,"K&K 2,3,4,6",13,"K&K 2,3",15,K&K 4,12,K&K 6,7,"A.P F 3,4",11,A.P F 5,68,97,8,3,11,108
285,29,"K&K 2,3,4,6",9,"K&K 2,3",12,K&K 4,0,K&K 6,0,"A.P F 3,4",0,A.P F 5,28,57,2,0,2,59
286,8,"K&K 2,3,4,6",7,"K&K 2,3",8,K&K 4,2,K&K 6,2,"A.P F 3,4",0,A.P F 5,26,34,4,2,6,40
287,2,"K&K 2,3,4,6",0,"K&K 2,3",2,K&K 4,0,K&K 6,0,"A.P F 3,4",0,A.P F 5,3,5,3,0,3,8
288,28,"K&K 2,3,4,6",14,"K&K 2,3",15,K&K 4,15,K&K 6,15,"A.P F 3,4",0,A.P F 5,79,107,10,7,17,124
289,53,"K&K 2,3,4,6",7,"K&K 2,3",11,K&K 4,2,K&K 6,13,"A.P F 3,4",11,A.P F 5,56,109,16,9,25,134
290,47,"K&K 2,3,4,6",0,"K&K 2,3",15,K&K 4,9,K&K 6,2,"A.P F 3,4",8,A.P F 5,46,93,11,19,30,123
291,19,"K&K 2,3,4,6",0,"K&K 2,3",15,K&K 4,15,K&K 6,13,"A.P F 3,4",14,A.P F 5,76,95,17,14,31,126
292,1,"K&K 2,3,4,6",0,"K&K 2,3",6,K&K 4,12,K&K 6,9,"A.P F 3,4",6,A.P F 5,44,45,3,5,8,53
293,52,"K&K 2,3,4,6",3,"K&K 2,3",10,K&K 4,15,K&K 6,10,"A.P F 3,4",1,A.P F 5,51,103,14,8,22,125
294,33,"K&K 2,3,4,6",0,"K&K 2,3",0,K&K 4,0,K&K 6,0,"A.P F 3,4",0,A.P F 5,0,33,11,0,11,44
295,5,"K&K 2,3,4,6",0,"K&K 2,3",0,K&K 4,0,K&K 6,0,"A.P F 3,4",0,A.P F 5,0,5,2,0,2,7
296,47,"K&K 2,3,4,6",11,"K&K 2,3",9,K&K 4,3,K&K 6,4,"A.P F 3,4",2,A.P F 5,35,82,16,8,24,106
297,54,"K&K 2,3,4,6",13,"K&K 2,3",15,K&K 4,11,K&K 6,10,"A.P F 3,4",15,A.P F 5,72,126,23,17,40,166
298,23,"K&K 2,3,4,6",2,"K&K 2,3",11,K&K 4,9,K&K 6,1,"A.P F 3,4",15,A.P F 5,50,73,12,10,22,95
299,11,"K&K 2,3,4,6",9,"K&K 2,3",15,K&K 4,10,K&K 6,8,"A.P F 3,4",5,A.P F 5,56,67,13,9,22,89
300,48,"K&K 2,3,4,6",13,"K&K 2,3",13,K&K 4,5,K&K 6,13,"A.P F 3,4",6,A.P F 5,60,108,18,4,22,130
301,81,"K&K 2,3,4,6",0,"K&K 2,3",15,K&K 4,15,K&K 6,0,"A.P F 3,4",6,A.P F 5,48,129,9,15,24,153
302,5,"K&K 2,3,4,6",6,"K&K 2,3",8,K&K 4,5,K&K 6,15,"A.P F 3,4",15,A.P F 5,59,64,2,5,7,71
303,69,"K&K 2,3,4,6",4,"K&K 2,3",15,K&K 4,2,K&K 6,14,"A.P F 3,4",10,A.P F 5,58,127,26,19,45,172
304,7,"K&K 2,3,4,6",15,"K&K 2,3",15,K&K 4,15,K&K 6,15,"A.P F 3,4",12,A.P F 5,80,87,6,0,6,93
305,44,"K&K 2,3,4,6",0,"K&K 2,3",6,K&K 4,3,K&K 6,15,"A.P F 3,4",15,A.P F 5,52,96,12,11,23,119
306,33,"K&K 2,3,4,6",11,"K&K 2,3",14,K&K 4,10,K&K 6,0,"A.P F 3,4",5,A.P F 5,54,87,8,3,11,98
307,4,"K&K 2,3,4,6",0,"K&K 2,3",6,K&K 4,0,K&K 6,11,"A.P F 3,4",5,A.P F 5,30,34,4,3,7,41
308,9,"K&K 2,3,4,6",14,"K&K 2,3",3,K&K 4,15,K&K 6,15,"A.P F 3,4",15,A.P F 5,79,88,8,3,11,99
309,10,"K&K 2,3,4,6",0,"K&K 2,3",15,K&K 4,2,K&K 6,4,"A.P F 3,4",10,A.P F 5,42,52,2,4,6,58
310,39,"K&K 2,3,4,6",1,"K&K 2,3",15,K&K 4,5,K&K 6,1,"A.P F 3,4",13,A.P F 5,46,85,8,12,20,105
311,11,"K&K 2,3,4,6",0,"K&K 2,3",15,K&K 4,0,K&K 6,14,"A.P F 3,4",13,A.P F 5,56,67,5,1,6,73
312,20,"K&K 2,3,4,6",0,"K&K 2,3",15,K&K 4,15,K&K 6,6,"A.P F 3,4",14,A.P F 5,67,87,27,7,34,121
313,1,"K&K 2,3,4,6",0,"K&K 2,3",11,K&K 4,4,K&K 6,0,"A.P F 3,4",11,A.P F 5,35,36,3,3,6,42
314,3,"K&K 2,3,4,6",0,"K&K 2,3",8,K&K 4,15,K&K 6,0,"A.P F 3,4",0,A.P F 5,31,34,0,0,0,34
315,49,"K&K 2,3,4,6",13,"K&K 2,3",10,K&K 4,0,K&K 6,6,"A.P F 3,4",12,A.P F 5,55,104,12,17,29,133
316,26,"K&K 2,3,4,6",0,"K&K 2,3",12,K&K 4,15,K&K 6,4,"A.P F 3,4",12,A.P F 5,58,84,9,18,27,111
317,93,"K&K 2,3,4,6",14,"K&K 2,3",15,K&K 4,15,K&K 6,0,"A.P F 3,4",8,A.P F 5,70,163,13,10,23,186
318,4,"K&K 2,3,4,6",5,"K&K 2,3",7,K&K 4,0,K&K 6,1,"A.P F 3,4",6,A.P F 5,26,30,0,3,3,33
319,73,"K&K 2,3,4,6",9,"K&K 2,3",14,K&K 4,15,K&K 6,8,"A.P F 3,4",11,A.P F 5,66,139,16,9,25,164
320,34,"K&K 2,3,4,6",3,"K&K 2,3",15,K&K 4,0,K&K 6,15,"A.P F 3,4",13,A.P F 5,62,96,12,6,18,114
321,25,"K&K 2,3,4,6",0,"K&K 2,3",2,K&K 4,0,K&K 6,7,"A.P F 3,4",0,A.P F 5,12,37,12,7,19,56
322,30,"K&K 2,3,4,6",14,"K&K 2,3",15,K&K 4,14,K&K 6,15,"A.P F 3,4",0,A.P F 5,78,108,18,7,25,133
323,72,"K&K 2,3,4,6",14,"K&K 2,3",14,K&K 4,14,K&K 6,1,"A.P F 3,4",15,A.P F 5,76,148,14,13,27,175
324,27,"K&K 2,3,4,6",15,"K&K 2,3",15,K&K 4,7,K&K 6,0,"A.P F 3,4",15,A.P F 5,70,97,19,7,26,123
325,61,"K&K 2,3,4,6",9,"K&K 2,3",11,K&K 4,15,K&K 6,15,"A.P F 3,4",0,A.P F 5,67,128,24,12,36,164
326,29,"K&K 2,3,4,6",13,"K&K 2,3",0,K&K 4,15,K&K 6,15,"A.P F 3,4",15,A.P F 5,78,107,11,2,13,120
327,27,"K&K 2,3,4,6",1,"K&K 2,3",15,K&K 4,6,K&K 6,1,"A.P F 3,4",13,A.P F 5,47,74,8,5,13,87
328,24,"K&K 2,3,4,6",5,"K&K 2,3",12,K&K 4,15,K&K 6,15,"A.P F 3,4",15,A.P F 5,76,100,12,11,23,123
329,0,"K&K 2,3,4,6",0,"K&K 2,3",0,K&K 4,0,K&K 6,0,"A.P F 3,4",7,A.P F 5,10,10,0,0,0,10
330,18,"K&K 2,3,4,6",15,"K&K 2,3",15,K&K 4,8,K&K 6,12,"A.P F 3,4",13,A.P F 5,74,92,13,4,17,109
331,0,"K&K 2,3,4,6",0,"K&K 2,3",0,K&K 4,0,K&K 6,0,"A.P F 3,4",0,A.P F 5,0,0,0,0,0,0
332,39,"K&K 2,3,4,6",9,"K&K 2,3",15,K&K 4,5,K&K 6,8,"A.P F 3,4",8,A.P F 5,54,93,9,16,25,118
333,15,"K&K 2,3,4,6",5,"K&K 2,3",10,K&K 4,15,K&K 6,4,"A.P F 3,4",15,A.P F 5,60,75,6,3,9,84
334,44,"K&K 2,3,4,6",15,"K&K 2,3",15,K&K 4,1,K&K 6,15,"A.P F 3,4",8,A.P F 5,71,115,10,16,26,141
335,24,"K&K 2,3,4,6",15,"K&K 2,3",11,K&K 4,5,K&K 6,6,"A.P F 3,4",0,A.P F 5,49,73,15,14,29,102
336,5,"K&K 2,3,4,6",3,"K&K 2,3",9,K&K 4,5,K&K 6,2,"A.P F 3,4",15,A.P F 5,43,48,3,3,6,54
337,17,"K&K 2,3,4,6",2,"K&K 2,3",9,K&K 4,1,K&K 6,4,"A.P F 3,4",5,A.P F 5,27,44,12,3,15,59
338,23,"K&K 2,3,4,6",0,"K&K 2,3",15,K&K 4,15,K&K 6,15,"A.P F 3,4",15,A.P F 5,80,103,14,6,20,123
339,56,"K&K 2,3,4,6",14,"K&K 2,3",15,K&K 4,12,K&K 6,15,"A.P F 3,4",15,A.P F 5,79,135,29,29,58,193
340,18,"K&K 2,3,4,6",1,"K&K 2,3",6,K&K 4,6,K&K 6,3,"A.P F 3,4",7,A.P F 5,30,48,0,2,2,50
341,16,"K&K 2,3,4,6",2,"K&K 2,3",1,K&K 4,5,K&K 6,5,"A.P F 3,4",14,A.P F 5,35,51,3,9,12,63
342,46,"K&K 2,3,4,6",13,"K&K 2,3",15,K&K 4,9,K&K 6,7,"A.P F 3,4",4,A.P F 5,59,105,9,21,30,135
343,9,"K&K 2,3,4,6",0,"K&K 2,3",0,K&K 4,0,K&K 6,0,"A.P F 3,4",2,A.P F 5,3,12,8,1,9,21
344,23,"K&K 2,3,4,6",0,"K&K 2,3",2,K&K 4,4,K&K 6,2,"A.P F 3,4",,A.P F 5,11,34,5,3,8,42
345,26,"K&K 2,3,4,6",6,"K&K 2,3",15,K&K 4,15,K&K 6,14,"A.P F 3,4",15,A.P F 5,79,105,14,11,25,130
346,5,"K&K 2,3,4,6",0,"K&K 2,3",0,K&K 4,2,K&K 6,0,"A.P F 3,4",1,A.P F 5,4,9,3,1,4,13
347,24,"K&K 2,3,4,6",3,"K&K 2,3",10,K&K 4,15,K&K 6,13,"A.P F 3,4",3,A.P F 5,55,79,19,14,33,112
348,38,"K&K 2,3,4,6",10,"K&K 2,3",11,K&K 4,7,K&K 6,4,"A.P F 3,4",11,A.P F 5,52,90,6,7,13,103
349,13,"K&K 2,3,4,6",5,"K&K 2,3",15,K&K 4,12,K&K 6,4,"A.P F 3,4",9,A.P F 5,55,68,5,6,11,79
350,34,"K&K 2,3,4,6",10,"K&K 2,3",13,K&K 4,15,K&K 6,15,"A.P F 3,4",15,A.P F 5,78,112,21,12,33,145
351,24,"K&K 2,3,4,6",7,"K&K 2,3",14,K&K 4,15,K&K 6,15,"A.P F 3,4",15,A.P F 5,79,103,2,4,6,109
352,3,"K&K 2,3,4,6",6,"K&K 2,3",6,K&K 4,1,K&K 6,1,"A.P F 3,4",2,A.P F 5,20,23,0,0,0,23
353,98,"K&K 2,3,4,6",10,"K&K 2,3",15,K&K 4,4,K&K 6,4,"A.P F 3,4",11,A.P F 5,54,152,28,38,66,218
354,79,"K&K 2,3,4,6",15,"K&K 2,3",15,K&K 4,15,K&K 6,15,"A.P F 3,4",0,A.P F 5,80,159,32,32,64,223
355,40,"K&K 2,3,4,6",2,"K&K 2,3",15,K&K 4,14,K&K 6,15,"A.P F 3,4",10,A.P F 5,72,112,14,7,21,133
356,81,"K&K 2,3,4,6",15,"K&K 2,3",15,K&K 4,12,K&K 6,4,"A.P F 3,4",15,A.P F 5,76,157,22,8,30,187
357,42,"K&K 2,3,4,6",15,"K&K 2,3",2,K&K 4,4,K&K 6,5,"A.P F 3,4",15,A.P F 5,52,94,6,6,12,106
358,36,"K&K 2,3,4,6",7,"K&K 2,3",2,K&K 4,14,K&K 6,6,"A.P F 3,4",15,A.P F 5,56,92,7,19,26,118
359,17,"K&K 2,3,4,6",1,"K&K 2,3",15,K&K 4,15,K&K 6,1,"A.P F 3,4",15,A.P F 5,62,79,8,5,13,92
360,27,"K&K 2,3,4,6",9,"K&K 2,3",15,K&K 4,10,K&K 6,9,"A.P F 3,4",15,A.P F 5,66,93,9,5,14,107
361,86,"K&K 2,3,4,6",14,"K&K 2,3",15,K&K 4,15,K&K 6,4,"A.P F 3,4",15,A.P F 5,79,165,18,16,34,199
362,39,"K&K 2,3,4,6",6,"K&K 2,3",15,K&K 4,15,K&K 6,2,"A.P F 3,4",0,A.P F 5,51,90,11,8,19,109
363,0,"K&K 2,3,4,6",1,"K&K 2,3",9,K&K 4,0,K&K 6,1,"A.P F 3,4",0,A.P F 5,15,15,0,1,1,16
364,33,"K&K 2,3,4,6",10,"K&K 2,3",15,K&K 4,7,K&K 6,0,"A.P F 3,4",7,A.P F 5,52,85,15,6,21,106
365,70,"K&K 2,3,4,6",1,"K&K 2,3",6,K&K 4,7,K&K 6,4,"A.P F 3,4",15,A.P F 5,43,113,19,15,34,147
366,57,"K&K 2,3,4,6",3,"K&K 2,3",8,K&K 4,15,K&K 6,1,"A.P F 3,4",1,A.P F 5,36,93,15,7,22,115
367,11,"K&K 2,3,4,6",0,"K&K 2,3",14,K&K 4,6,K&K 6,4,"A.P F 3,4",0,A.P F 5,32,43,0,3,3,46
368,27,"K&K 2,3,4,6",0,"K&K 2,3",15,K&K 4,0,K&K 6,6,"A.P F 3,4",10,A.P F 5,42,69,12,3,15,84
369,12,"K&K 2,3,4,6",0,"K&K 2,3",4,K&K 4,6,K&K 6,0,"A.P F 3,4",6,A.P F 5,22,34,3,7,10,44
370,0,"K&K 2,3,4,6",0,"K&K 2,3",0,K&K 4,0,K&K 6,0,"A.P F 3,4",0,A.P F 5,0,0,0,0,0,0
371,56,"K&K 2,3,4,6",2,"K&K 2,3",5,K&K 4,6,K&K 6,2,"A.P F 3,4",0,A.P F 5,20,76,17,5,22,98
372,10,"K&K 2,3,4,6",0,"K&K 2,3",15,K&K 4,0,K&K 6,0,"A.P F 3,4",0,A.P F 5,20,30,0,3,3,33
373,0,"K&K 2,3,4,6",0,"K&K 2,3",0,K&K 4,0,K&K 6,0,"A.P F 3,4",0,A.P F 5,0,0,0,0,0,0
374,2,"K&K 2,3,4,6",0,"K&K 2,3",15,K&K 4,9,K&K 6,0,"A.P F 3,4",8,A.P F 5,43,45,0,0,0,45
375,45,"K&K 2,3,4,6",11,"K&K 2,3",11,K&K 4,8,K&K 6,14,"A.P F 3,4",14,A.P F 5,67,112,14,10,24,136
376,17,"K&K 2,3,4,6",5,"K&K 2,3",11,K&K 4,11,K&K 6,13,"A.P F 3,4",15,A.P F 5,67,84,8,12,20,104
377,15,"K&K 2,3,4,6",2,"K&K 2,3",11,K&K 4,0,K&K 6,1,"A.P F 3,4",15,A.P F 5,39,54,4,0,4,58
378,40,"K&K 2,3,4,6",13,"K&K 2,3",15,K&K 4,15,K&K 6,15,"A.P F 3,4",15,A.P F 5,80,120,25,5,30,150
379,15,"K&K 2,3,4,6",7,"K&K 2,3",10,K&K 4,11,K&K 6,7,"A.P F 3,4",6,A.P F 5,47,62,16,12,28,90
380,51,"K&K 2,3,4,6",2,"K&K 2,3",15,K&K 4,15,K&K 6,15,"A.P F 3,4",13,A.P F 5,78,129,23,11,34,163
381,56,"K&K 2,3,4,6",11,"K&K 2,3",13,K&K 4,12,K&K 6,15,"A.P F 3,4",4,A.P F 5,68,124,17,7,24,148
382,3,"K&K 2,3,4,6",0,"K&K 2,3",0,K&K 4,0,K&K 6,0,"A.P F 3,4",6,A.P F 5,8,11,4,0,4,15
383,16,"K&K 2,3,4,6",2,"K&K 2,3",15,K&K 4,0,K&K 6,1,"A.P F 3,4",8,A.P F 5,35,51,8,0,8,59
384,4,"K&K 2,3,4,6",7,"K&K 2,3",4,K&K 4,3,K&K 6,0,"A.P F 3,4",15,A.P F 5,39,43,6,0,6,49
385,21,"K&K 2,3,4,6",10,"K&K 2,3",15,K&K 4,10,K&K 6,2,"A.P F 3,4",4,A.P F 5,52,73,3,5,8,81
386,31,"K&K 2,3,4,6",6,"K&K 2,3",15,K&K 4,3,K&K 6,9,"A.P F 3,4",13,A.P F 5,57,88,21,13,34,122
387,10,"K&K 2,3,4,6",1,"K&K 2,3",3,K&K 4,1,K&K 6,0,"A.P F 3,4",8,A.P F 5,18,28,6,2,8,36
388,31,"K&K 2,3,4,6",1,"K&K 2,3",14,K&K 4,4,K&K 6,1,"A.P F 3,4",0,A.P F 5,27,58,9,1,10,68
389,8,"K&K 2,3,4,6",2,"K&K 2,3",7,K&K 4,6,K&K 6,6,"A.P F 3,4",15,A.P F 5,46,54,2,0,2,56
390,13,"K&K 2,3,4,6",2,"K&K 2,3",15,K&K 4,2,K&K 6,4,"A.P F 3,4",15,A.P F 5,48,61,3,1,4,65
391,24,"K&K 2,3,4,6",2,"K&K 2,3",9,K&K 4,4,K&K 6,4,"A.P F 3,4",11,A.P F 5,38,62,10,5,15,77
392,67,"K&K 2,3,4,6",11,"K&K 2,3",15,K&K 4,15,K&K 6,14,"A.P F 3,4",15,A.P F 5,79,146,44,20,64,210
393,23,"K&K 2,3,4,6",6,"K&K 2,3",2,K&K 4,3,K&K 6,3,"A.P F 3,4",5,A.P F 5,23,46,9,4,13,59
394,49,"K&K 2,3,4,6",9,"K&K 2,3",2,K&K 4,0,K&K 6,0,"A.P F 3,4",0,A.P F 5,15,64,15,13,28,92
395,29,"K&K 2,3,4,6",12,"K&K 2,3",10,K&K 4,1,K&K 6,3,"A.P F 3,4",11,A.P F 5,48,77,12,9,21,98
396,5,"K&K 2,3,4,6",1,"K&K 2,3",0,K&K 4,3,K&K 6,0,"A.P F 3,4",0,A.P F 5,6,11,8,0,8,19
397,28,"K&K 2,3,4,6",9,"K&K 2,3",15,K&K 4,15,K&K 6,0,"A.P F 3,4",0,A.P F 5,52,80,17,4,21,101
398,49,"K&K 2,3,4,6",3,"K&K 2,3",3,K&K 4,3,K&K 6,4,"A.P F 3,4",0,A.P F 5,18,67,21,10,31,98
399,20,"K&K 2,3,4,6",8,"K&K 2,3",9,K&K 4,15,K&K 6,12,"A.P F 3,4",1,A.P F 5,59,79,14,12,26,105
400,56,"K&K 2,3,4,6",4,"K&K 2,3",0,K&K 4,0,K&K 6,7,"A.P F 3,4",5,A.P F 5,22,78,24,2,26,104
401,38,"K&K 2,3,4,6",11,"K&K 2,3",11,K&K 4,15,K&K 6,15,"A.P F 3,4",11,A.P F 5,70,108,11,24,35,143
402,27,"K&K 2,3,4,6",15,"K&K 2,3",11,K&K 4,9,K&K 6,7,"A.P F 3,4",9,A.P F 5,59,86,14,4,18,104
403,30,"K&K 2,3,4,6",15,"K&K 2,3",4,K&K 4,15,K&K 6,7,"A.P F 3,4",15,A.P F 5,70,100,15,17,32,132
404,15,"K&K 2,3,4,6",13,"K&K 2,3",7,K&K 4,15,K&K 6,1,"A.P F 3,4",1,A.P F 5,48,63,9,1,10,73
405,12,"K&K 2,3,4,6",7,"K&K 2,3",15,K&K 4,0,K&K 6,0,"A.P F 3,4",15,A.P F 5,50,62,5,4,9,71
406,35,"K&K 2,3,4,6",15,"K&K 2,3",13,K&K 4,5,K&K 6,8,"A.P F 3,4",15,A.P F 5,68,103,8,29,37,140
407,15,"K&K 2,3,4,6",15,"K&K 2,3",15,K&K 4,15,K&K 6,12,"A.P F 3,4",10,A.P F 5,76,91,19,2,21,112
408,58,"K&K 2,3,4,6",15,"K&K 2,3",8,K&K 4,15,K&K 6,15,"A.P F 3,4",13,A.P F 5,78,136,33,29,62,198
409,0,"K&K 2,3,4,6",1,"K&K 2,3",10,K&K 4,0,K&K 6,1,"A.P F 3,4",0,A.P F 5,16,16,6,0,6,22
410,5,"K&K 2,3,4,6",2,"K&K 2,3",2,K&K 4,3,K&K 6,5,"A.P F 3,4",1,A.P F 5,16,21,6,0,6,27
411,25,"K&K 2,3,4,6",5,"K&K 2,3",2,K&K 4,3,K&K 6,0,"A.P F 3,4",1,A.P F 5,14,39,12,8,20,59
412,6,"K&K 2,3,4,6",15,"K&K 2,3",5,K&K 4,15,K&K 6,4,"A.P F 3,4",10,A.P F 5,60,66,12,9,21,87
413,61,"K&K 2,3,4,6",10,"K&K 2,3",0,K&K 4,15,K&K 6,14,"A.P F 3,4",15,A.P F 5,72,133,22,5,27,160
414,17,"K&K 2,3,4,6",5,"K&K 2,3",4,K&K 4,0,K&K 6,0,"A.P F 3,4",15,A.P F 5,32,49,15,3,18,67
415,68,"K&K 2,3,4,6",11,"K&K 2,3",15,K&K 4,15,K&K 6,6,"A.P F 3,4",12,A.P F 5,71,139,34,31,65,204
416,44,"K&K 2,3,4,6",14,"K&K 2,3",15,K&K 4,10,K&K 6,1,"A.P F 3,4",15,A.P F 5,72,116,10,6,16,132
417,19,"K&K 2,3,4,6",6,"K&K 2,3",13,K&K 4,8,K&K 6,6,"A.P F 3,4",15,A.P F 5,56,75,14,6,20,95
418,42,"K&K 2,3,4,6",15,"K&K 2,3",9,K&K 4,4,K&K 6,15,"A.P F 3,4",15,A.P F 5,72,114,20,10,30,144
419,30,"K&K 2,3,4,6",12,"K&K 2,3",7,K&K 4,9,K&K 6,2,"A.P F 3,4",6,A.P F 5,46,76,16,7,23,99
420,16,"K&K 2,3,4,6",0,"K&K 2,3",15,K&K 4,12,K&K 6,6,"A.P F 3,4",15,A.P F 5,64,80,8,8,16,96
421,18,"K&K 2,3,4,6",2,"K&K 2,3",1,K&K 4,6,K&K 6,6,"A.P F 3,4",10,A.P F 5,32,50,24,2,26,76
422,11,"K&K 2,3,4,6",2,"K&K 2,3",15,K&K 4,12,K&K 6,0,"A.P F 3,4",15,A.P F 5,59,70,21,3,24,94
423,67,"K&K 2,3,4,6",11,"K&K 2,3",10,K&K 4,4,K&K 6,5,"A.P F 3,4",6,A.P F 5,43,110,21,20,41,151
424,59,"K&K 2,3,4,6",5,"K&K 2,3",13,K&K 4,4,K&K 6,4,"A.P F 3,4",1,A.P F 5,35,94,29,15,44,138
425,54,"K&K 2,3,4,6",15,"K&K 2,3",15,K&K 4,15,K&K 6,0,"A.P F 3,4",15,A.P F 5,80,134,23,25,48,182
426,14,"K&K 2,3,4,6",3,"K&K 2,3",5,K&K 4,8,K&K 6,1,"A.P F 3,4",1,A.P F 5,23,37,8,5,13,50
427,60,"K&K 2,3,4,6",15,"K&K 2,3",14,K&K 4,15,K&K 6,15,"A.P F 3,4",11,A.P F 5,79,139,29,24,53,192
428,19,"K&K 2,3,4,6",3,"K&K 2,3",0,K&K 4,15,K&K 6,12,"A.P F 3,4",11,A.P F 5,55,74,9,15,24,98
429,28,"K&K 2,3,4,6",0,"K&K 2,3",14,K&K 4,0,K&K 6,2,"A.P F 3,4",6,A.P F 5,30,58,10,4,14,72
430,39,"K&K 2,3,4,6",4,"K&K 2,3",14,K&K 4,8,K&K 6,2,"A.P F 3,4",1,A.P F 5,38,77,3,4,7,84
431,14,"K&K 2,3,4,6",0,"K&K 2,3",0,K&K 4,0,K&K 6,0,"A.P F 3,4",0,A.P F 5,0,14,9,2,11,25
432,29,"K&K 2,3,4,6",0,"K&K 2,3",11,K&K 4,4,K&K 6,5,"A.P F 3,4",2,A.P F 5,30,59,19,7,26,85
433,21,"K&K 2,3,4,6",7,"K&K 2,3",14,K&K 4,6,K&K 6,3,"A.P F 3,4",6,A.P F 5,44,65,6,6,12,77
434,74,"K&K 2,3,4,6",12,"K&K 2,3",15,K&K 4,15,K&K 6,4,"A.P F 3,4",15,A.P F 5,76,150,17,2,19,169
435,21,"K&K 2,3,4,6",10,"K&K 2,3",9,K&K 4,5,K&K 6,4,"A.P F 3,4",5,A.P F 5,39,60,12,10,22,82
436,40,"K&K 2,3,4,6",13,"K&K 2,3",6,K&K 4,6,K&K 6,12,"A.P F 3,4",4,A.P F 5,50,90,3,4,7,97
437,7,"K&K 2,3,4,6",2,"K&K 2,3",15,K&K 4,15,K&K 6,15,"A.P F 3,4",13,A.P F 5,78,85,11,2,13,98
438,62,"K&K 2,3,4,6",0,"K&K 2,3",15,K&K 4,6,K&K 6,4,"A.P F 3,4",11,A.P F 5,48,110,12,11,23,133
439,38,"K&K 2,3,4,6",14,"K&K 2,3",13,K&K 4,11,K&K 6,15,"A.P F 3,4",13,A.P F 5,74,112,31,14,45,157
440,26,"K&K 2,3,4,6",0,"K&K 2,3",15,K&K 4,15,K&K 6,10,"A.P F 3,4",11,A.P F 5,68,94,12,2,14,108
441,69,"K&K 2,3,4,6",10,"K&K 2,3",14,K&K 4,13,K&K 6,0,"A.P F 3,4",11,A.P F 5,64,133,19,0,19,152
442,38,"K&K 2,3,4,6",15,"K&K 2,3",15,K&K 4,15,K&K 6,12,"A.P F 3,4",15,A.P F 5,80,118,27,14,41,159
443,72,"K&K 2,3,4,6",6,"K&K 2,3",1,K&K 4,8,K&K 6,11,"A.P F 3,4",4,A.P F 5,39,111,22,18,40,151
444,33,"K&K 2,3,4,6",0,"K&K 2,3",12,K&K 4,13,K&K 6,0,"A.P F 3,4",0,A.P F 5,34,67,9,0,9,76
445,0,"K&K 2,3,4,6",2,"K&K 2,3",10,K&K 4,0,K&K 6,0,"A.P F 3,4",0,A.P F 5,15,15,9,0,9,24
446,39,"K&K 2,3,4,6",5,"K&K 2,3",15,K&K 4,15,K&K 6,6,"A.P F 3,4",15,A.P F 5,68,107,18,4,22,129
447,62,"K&K 2,3,4,6",15,"K&K 2,3",15,K&K 4,15,K&K 6,15,"A.P F 3,4",13,A.P F 5,80,142,27,16,43,185
448,80,"K&K 2,3,4,6",15,"K&K 2,3",15,K&K 4,4,K&K 6,0,"A.P F 3,4",6,A.P F 5,54,134,28,26,54,188
449,4,"K&K 2,3,4,6",0,"K&K 2,3",0,K&K 4,0,K&K 6,0,"A.P F 3,4",0,A.P F 5,0,4,0,0,0,4
450,1,"K&K 2,3,4,6",2,"K&K 2,3",0,K&K 4,0,K&K 6,0,"A.P F 3,4",0,A.P F 5,3,4,5,0,5,9
451,54,"K&K 2,3,4,6",4,"K&K 2,3",0,K&K 4,15,K&K 6,15,"A.P F 3,4",15,A.P F 5,66,120,15,10,25,145
452,42,"K&K 2,3,4,6",15,"K&K 2,3",15,K&K 4,15,K&K 6,0,"A.P F 3,4",10,A.P F 5,74,116,5,1,6,122
453,53,"K&K 2,3,4,6",15,"K&K 2,3",15,K&K 4,8,K&K 6,15,"A.P F 3,4",15,A.P F 5,80,133,29,27,56,189
454,44,"K&K 2,3,4,6",7,"K&K 2,3",15,K&K 4,15,K&K 6,10,"A.P F 3,4",15,A.P F 5,74,118,10,8,18,136
455,49,"K&K 2,3,4,6",9,"K&K 2,3",15,K&K 4,15,K&K 6,15,"A.P F 3,4",15,A.P F 5,80,129,27,5,32,161
456,17,"K&K 2,3,4,6",12,"K&K 2,3",4,K&K 4,10,K&K 6,5,"A.P F 3,4",13,A.P F 5,54,71,12,13,25,96
457,33,"K&K 2,3,4,6",14,"K&K 2,3",15,K&K 4,12,K&K 6,0,"A.P F 3,4",14,A.P F 5,74,107,12,7,19,126
458,38,"K&K 2,3,4,6",2,"K&K 2,3",0,K&K 4,0,K&K 6,1,"A.P F 3,4",0,A.P F 5,4,42,18,1,19,61
459,62,"K&K 2,3,4,6",15,"K&K 2,3",15,K&K 4,15,K&K 6,15,"A.P F 3,4",15,A.P F 5,80,142,25,7,32,174
460,20,"K&K 2,3,4,6",2,"K&K 2,3",10,K&K 4,4,K&K 6,0,"A.P F 3,4",12,A.P F 5,38,58,6,3,9,67
461,76,"K&K 2,3,4,6",15,"K&K 2,3",15,K&K 4,3,K&K 6,0,"A.P F 3,4",12,A.P F 5,60,136,26,28,54,190
462,44,"K&K 2,3,4,6",4,"K&K 2,3",12,K&K 4,4,K&K 6,4,"A.P F 3,4",0,A.P F 5,32,76,12,8,20,96
463,0,"K&K 2,3,4,6",0,"K&K 2,3",11,K&K 4,4,K&K 6,15,"A.P F 3,4",12,A.P F 5,56,56,3,0,3,59
464,47,"K&K 2,3,4,6",3,"K&K 2,3",9,K&K 4,12,K&K 6,8,"A.P F 3,4",12,A.P F 5,55,102,12,1,13,115
465,13,"K&K 2,3,4,6",6,"K&K 2,3",14,K&K 4,11,K&K 6,12,"A.P F 3,4",8,A.P F 5,60,73,18,5,23,96
466,44,"K&K 2,3,4,6",0,"K&K 2,3",8,K&K 4,15,K&K 6,11,"A.P F 3,4",15,A.P F 5,66,110,32,33,65,175
467,3,"K&K 2,3,4,6",0,"K&K 2,3",0,K&K 4,3,K&K 6,0,"A.P F 3,4",0,A.P F 5,4,7,13,3,16,23
468,55,"K&K 2,3,4,6",7,"K&K 2,3",15,K&K 4,15,K&K 6,2,"A.P F 3,4",2,A.P F 5,52,107,24,13,37,144
469,45,"K&K 2,3,4,6",1,"K&K 2,3",15,K&K 4,15,K&K 6,5,"A.P F 3,4",15,A.P F 5,67,112,18,6,24,136
470,13,"K&K 2,3,4,6",10,"K&K 2,3",11,K&K 4,6,K&K 6,13,"A.P F 3,4",13,A.P F 5,63,76,25,33,58,134
471,6,"K&K 2,3,4,6",2,"K&K 2,3",2,K&K 4,2,K&K 6,4,"A.P F 3,4",8,A.P F 5,22,28,0,9,9,37
472,0,"K&K 2,3,4,6",0,"K&K 2,3",0,K&K 4,0,K&K 6,4,"A.P F 3,4",1,A.P F 5,7,7,0,0,0,7
473,50,"K&K 2,3,4,6",6,"K&K 2,3",15,K&K 4,13,K&K 6,6,"A.P F 3,4",15,A.P F 5,66,116,29,15,44,160
474,40,"K&K 2,3,4,6",13,"K&K 2,3",4,K&K 4,0,K&K 6,4,"A.P F 3,4",12,A.P F 5,44,84,12,3,15,99
475,80,"K&K 2,3,4,6",5,"K&K 2,3",7,K&K 4,8,K&K 6,2,"A.P F 3,4",13,A.P F 5,44,124,14,7,21,145
476,42,"K&K 2,3,4,6",13,"K&K 2,3",15,K&K 4,15,K&K 6,15,"A.P F 3,4",1,A.P F 5,78,120,19,20,39,159
477,43,"K&K 2,3,4,6",3,"K&K 2,3",15,K&K 4,0,K&K 6,15,"A.P F 3,4",11,A.P F 5,59,102,21,21,42,144
478,36,"K&K 2,3,4,6",0,"K&K 2,3",13,K&K 4,4,K&K 6,0,"A.P F 3,4",15,A.P F 5,43,79,9,11,20,99
479,34,"K&K 2,3,4,6",12,"K&K 2,3",11,K&K 4,15,K&K 6,12,"A.P F 3,4",15,A.P F 5,72,106,14,10,24,130
480,61,"K&K 2,3,4,6",8,"K&K 2,3",15,K&K 4,10,K&K 6,4,"A.P F 3,4",15,A.P F 5,64,125,32,39,71,196
481,15,"K&K 2,3,4,6",0,"K&K 2,3",14,K&K 4,7,K&K 6,2,"A.P F 3,4",13,A.P F 5,48,63,9,1,10,73
482,37,"K&K 2,3,4,6",4,"K&K 2,3",10,K&K 4,13,K&K 6,6,"A.P F 3,4",6,A.P F 5,47,84,3,7,10,94
483,28,"K&K 2,3,4,6",10,"K&K 2,3",15,K&K 4,15,K&K 6,12,"A.P F 3,4",0,A.P F 5,70,98,2,2,4,102
484,67,"K&K 2,3,4,6",0,"K&K 2,3",10,K&K 4,2,K&K 6,15,"A.P F 3,4",15,A.P F 5,56,123,17,8,25,148
485,25,"K&K 2,3,4,6",5,"K&K 2,3",15,K&K 4,15,K&K 6,11,"A.P F 3,4",11,A.P F 5,70,95,22,0,22,117
486,32,"K&K 2,3,4,6",0,"K&K 2,3",15,K&K 4,15,K&K 6,15,"A.P F 3,4",15,A.P F 5,80,112,5,0,5,117
487,6,"K&K 2,3,4,6",2,"K&K 2,3",12,K&K 4,0,K&K 6,4,"A.P F 3,4",8,A.P F 5,35,41,0,4,4,45
488,58,"K&K 2,3,4,6",5,"K&K 2,3",15,K&K 4,15,K&K 6,4,"A.P F 3,4",3,A.P F 5,52,110,28,20,48,158
489,0,"K&K 2,3,4,6",0,"K&K 2,3",0,K&K 4,10,K&K 6,0,"A.P F 3,4",0,A.P F 5,14,14,0,0,0,14
490,21,"K&K 2,3,4,6",7,"K&K 2,3",2,K&K 4,15,K&K 6,15,"A.P F 3,4",15,A.P F 5,70,91,5,3,8,99
491,71,"K&K 2,3,4,6",7,"K&K 2,3",15,K&K 4,15,K&K 6,11,"A.P F 3,4",15,A.P F 5,75,146,30,29,59,205
492,14,"K&K 2,3,4,6",7,"K&K 2,3",15,K&K 4,15,K&K 6,4,"A.P F 3,4",15,A.P F 5,70,84,16,9,25,109
493,17,"K&K 2,3,4,6",2,"K&K 2,3",15,K&K 4,6,K&K 6,5,"A.P F 3,4",12,A.P F 5,51,68,14,2,16,84
494,39,"K&K 2,3,4,6",8,"K&K 2,3",15,K&K 4,4,K&K 6,4,"A.P F 3,4",1,A.P F 5,42,81,6,10,16,97
495,49,"K&K 2,3,4,6",0,"K&K 2,3",13,K&K 4,10,K&K 6,4,"A.P F 3,4",15,A.P F 5,56,105,10,10,20,125
496,26,"K&K 2,3,4,6",8,"K&K 2,3",9,K&K 4,6,K&K 6,3,"A.P F 3,4",15,A.P F 5,51,77,18,14,32,109
497,24,"K&K 2,3,4,6",2,"K&K 2,3",15,K&K 4,9,K&K 6,0,"A.P F 3,4",13,A.P F 5,52,76,9,1,10,86
498,40,"K&K 2,3,4,6",6,"K&K 2,3",14,K&K 4,15,K&K 6,15,"A.P F 3,4",15,A.P F 5,79,119,22,20,42,161
499,0,"K&K 2,3,4,6",0,"K&K 2,3",0,K&K 4,0,K&K 6,0,"A.P F 3,4",0,A.P F 5,0,0,3,0,3,3
500,1,"K&K 2,3,4,6",0,"K&K 2,3",5,K&K 4,2,K&K 6,15,"A.P F 3,4",15,A.P F 5,50,51,2,0,2,53
501,36,"K&K 2,3,4,6",11,"K&K 2,3",11,K&K 4,6,K&K 6,12,"A.P F 3,4",11,A.P F 5,60,96,5,5,10,106
502,25,"K&K 2,3,4,6",2,"K&K 2,3",0,K&K 4,13,K&K 6,0,"A.P F 3,4",7,A.P F 5,30,55,10,8,18,73
503,28,"K&K 2,3,4,6",12,"K&K 2,3",0,K&K 4,0,K&K 6,4,"A.P F 3,4",10,A.P F 5,35,63,20,1,21,84
504,61,"K&K 2,3,4,6",7,"K&K 2,3",14,K&K 4,15,K&K 6,10,"A.P F 3,4",15,A.P F 5,72,133,17,8,25,158
505,98,"K&K 2,3,4,6",12,"K&K 2,3",15,K&K 4,10,K&K 6,7,"A.P F 3,4",11,A.P F 5,64,162,33,10,43,205
506,27,"K&K 2,3,4,6",15,"K&K 2,3",4,K&K 4,15,K&K 6,15,"A.P F 3,4",15,A.P F 5,80,107,21,5,26,133
507,32,"K&K 2,3,4,6",11,"K&K 2,3",0,K&K 4,2,K&K 6,12,"A.P F 3,4",8,A.P F 5,44,76,2,10,12,88
508,67,"K&K 2,3,4,6",12,"K&K 2,3",15,K&K 4,11,K&K 6,15,"A.P F 3,4",15,A.P F 5,76,143,24,13,37,180
509,28,"K&K 2,3,4,6",10,"K&K 2,3",6,K&K 4,15,K&K 6,0,"A.P F 3,4",6,A.P F 5,50,78,9,6,15,93
510,21,"K&K 2,3,4,6",3,"K&K 2,3",0,K&K 4,6,K&K 6,1,"A.P F 3,4",0,A.P F 5,14,35,2,3,5,40
511,63,"K&K 2,3,4,6",4,"K&K 2,3",7,K&K 4,15,K&K 6,2,"A.P F 3,4",14,A.P F 5,54,117,20,10,30,147
512,77,"K&K 2,3,4,6",12,"K&K 2,3",15,K&K 4,15,K&K 6,15,"A.P F 3,4",13,A.P F 5,78,155,24,17,41,196
513,0,"K&K 2,3,4,6",0,"K&K 2,3",0,K&K 4,0,K&K 6,0,"A.P F 3,4",9,A.P F 5,12,12,0,3,3,15
514,11,"K&K 2,3,4,6",12,"K&K 2,3",3,K&K 4,4,K&K 6,10,"A.P F 3,4",6,A.P F 5,42,53,14,9,23,76
515,40,"K&K 2,3,4,6",0,"K&K 2,3",3,K&K 4,7,K&K 6,5,"A.P F 3,4",8,A.P F 5,31,71,22,5,27,98
516,39,"K&K 2,3,4,6",5,"K&K 2,3",15,K&K 4,15,K&K 6,12,"A.P F 3,4",15,A.P F 5,76,115,11,4,15,130
517,33,"K&K 2,3,4,6",9,"K&K 2,3",14,K&K 4,15,K&K 6,11,"A.P F 3,4",15,A.P F 5,73,106,25,8,33,139
518,62,"K&K 2,3,4,6",15,"K&K 2,3",15,K&K 4,9,K&K 6,15,"A.P F 3,4",15,A.P F 5,80,142,28,20,48,190
519,31,"K&K 2,3,4,6",3,"K&K 2,3",14,K&K 4,6,K&K 6,13,"A.P F 3,4",15,A.P F 5,64,95,23,8,31,126
520,18,"K&K 2,3,4,6",1,"K&K 2,3",9,K&K 4,4,K&K 6,4,"A.P F 3,4",2,A.P F 5,26,44,7,2,9,53
521,53,"K&K 2,3,4,6",5,"K&K 2,3",13,K&K 4,0,K&K 6,15,"A.P F 3,4",11,A.P F 5,59,112,29,6,35,147
522,84,"K&K 2,3,4,6",0,"K&K 2,3",15,K&K 4,10,K&K 6,15,"A.P F 3,4",13,A.P F 5,71,155,22,13,35,190
523,28,"K&K 2,3,4,6",7,"K&K 2,3",14,K&K 4,14,K&K 6,6,"A.P F 3,4",9,A.P F 5,59,87,16,7,23,110
524,56,"K&K 2,3,4,6",14,"K&K 2,3",13,K&K 4,15,K&K 6,15,"A.P F 3,4",7,A.P F 5,76,132,20,7,27,159
525,32,"K&K 2,3,4,6",1,"K&K 2,3",14,K&K 4,14,K&K 6,4,"A.P F 3,4",3,A.P F 5,47,79,9,6,15,94
526,14,"K&K 2,3,4,6",1,"K&K 2,3",12,K&K 4,0,K&K 6,15,"A.P F 3,4",14,A.P F 5,56,70,7,5,12,82
527,63,"K&K 2,3,4,6",5,"K&K 2,3",15,K&K 4,11,K&K 6,6,"A.P F 3,4",15,A.P F 5,63,126,8,9,17,143
528,48,"K&K 2,3,4,6",10,"K&K 2,3",15,K&K 4,15,K&K 6,4,"A.P F 3,4",15,A.P F 5,74,122,20,26,46,168
529,92,"K&K 2,3,4,6",1,"K&K 2,3",15,K&K 4,5,K&K 6,8,"A.P F 3,4",0,A.P F 5,39,131,25,22,47,178
530,32,"K&K 2,3,4,6",2,"K&K 2,3",15,K&K 4,10,K&K 6,4,"A.P F 3,4",15,A.P F 5,59,91,10,2,12,103
531,33,"K&K 2,3,4,6",12,"K&K 2,3",12,K&K 4,15,K&K 6,7,"A.P F 3,4",11,A.P F 5,67,100,6,3,9,109
532,42,"K&K 2,3,4,6",15,"K&K 2,3",15,K&K 4,11,K&K 6,15,"A.P F 3,4",0,A.P F 5,75,117,15,5,20,137
533,13,"K&K 2,3,4,6",12,"K&K 2,3",15,K&K 4,6,K&K 6,8,"A.P F 3,4",15,A.P F 5,67,80,10,5,15,95
534,56,"K&K 2,3,4,6",15,"K&K 2,3",15,K&K 4,15,K&K 6,15,"A.P F 3,4",9,A.P F 5,80,136,37,23,60,196
535,17,"K&K 2,3,4,6",0,"K&K 2,3",15,K&K 4,0,K&K 6,3,"A.P F 3,4",2,A.P F 5,27,44,12,5,17,61
536,3,"K&K 2,3,4,6",5,"K&K 2,3",0,K&K 4,7,K&K 6,12,"A.P F 3,4",15,A.P F 5,52,55,3,12,15,70
537,16,"K&K 2,3,4,6",1,"K&K 2,3",11,K&K 4,0,K&K 6,5,"A.P F 3,4",0,A.P F 5,23,39,13,11,24,63
538,34,"K&K 2,3,4,6",1,"K&K 2,3",15,K&K 4,2,K&K 6,1,"A.P F 3,4",0,A.P F 5,26,60,5,0,5,65
539,58,"K&K 2,3,4,6",5,"K&K 2,3",15,K&K 4,7,K&K 6,0,"A.P F 3,4",15,A.P F 5,56,114,23,18,41,155
540,49,"K&K 2,3,4,6",10,"K&K 2,3",13,K&K 4,15,K&K 6,15,"A.P F 3,4",13,A.P F 5,75,124,31,20,51,175
541,35,"K&K 2,3,4,6",2,"K&K 2,3",0,K&K 4,6,K&K 6,5,"A.P F 3,4",2,A.P F 5,20,55,14,9,23,78
542,16,"K&K 2,3,4,6",2,"K&K 2,3",1,K&K 4,0,K&K 6,0,"A.P F 3,4",0,A.P F 5,4,20,15,11,26,46
543,6,"K&K 2,3,4,6",6,"K&K 2,3",1,K&K 4,10,K&K 6,0,"A.P F 3,4",1,A.P F 5,24,30,3,0,3,33
544,31,"K&K 2,3,4,6",1,"K&K 2,3",15,K&K 4,7,K&K 6,12,"A.P F 3,4",15,A.P F 5,66,97,8,4,12,109
545,25,"K&K 2,3,4,6",2,"K&K 2,3",9,K&K 4,15,K&K 6,8,"A.P F 3,4",15,A.P F 5,63,88,19,6,25,113
546,73,"K&K 2,3,4,6",10,"K&K 2,3",15,K&K 4,11,K&K 6,14,"A.P F 3,4",7,A.P F 5,67,140,27,15,42,182
547,69,"K&K 2,3,4,6",12,"K&K 2,3",14,K&K 4,8,K&K 6,15,"A.P F 3,4",15,A.P F 5,75,144,28,38,66,210
548,11,"K&K 2,3,4,6",0,"K&K 2,3",2,K&K 4,3,K&K 6,0,"A.P F 3,4",1,A.P F 5,8,19,5,0,5,24
549,16,"K&K 2,3,4,6",15,"K&K 2,3",12,K&K 4,15,K&K 6,4,"A.P F 3,4",9,A.P F 5,68,84,13,10,23,107
550,24,"K&K 2,3,4,6",5,"K&K 2,3",6,K&K 4,10,K&K 6,11,"A.P F 3,4",11,A.P F 5,51,75,4,4,8,83
551,2,"K&K 2,3,4,6",0,"K&K 2,3",0,K&K 4,0,K&K 6,0,"A.P F 3,4",0,A.P F 5,0,2,3,0,3,5
552,17,"K&K 2,3,4,6",14,"K&K 2,3",5,K&K 4,8,K&K 6,4,"A.P F 3,4",15,A.P F 5,56,73,2,0,2,75
553,68,"K&K 2,3,4,6",11,"K&K 2,3",7,K&K 4,12,K&K 6,4,"A.P F 3,4",11,A.P F 5,55,123,22,3,25,148
554,2,"K&K 2,3,4,6",0,"K&K 2,3",0,K&K 4,0,K&K 6,0,"A.P F 3,4",0,A.P F 5,0,2,5,3,8,10
555,87,"K&K 2,3,4,6",15,"K&K 2,3",15,K&K 4,14,K&K 6,15,"A.P F 3,4",0,A.P F 5,79,166,36,29,65,231
556,14,"K&K 2,3,4,6",5,"K&K 2,3",15,K&K 4,6,K&K 6,1,"A.P F 3,4",1,A.P F 5,36,50,15,7,22,72
557,10,"K&K 2,3,4,6",3,"K&K 2,3",10,K&K 4,12,K&K 6,3,"A.P F 3,4",2,A.P F 5,38,48,7,0,7,55
558,75,"K&K 2,3,4,6",15,"K&K 2,3",15,K&K 4,14,K&K 6,0,"A.P F 3,4",4,A.P F 5,64,139,26,8,34,173
559,53,"K&K 2,3,4,6",15,"K&K 2,3",11,K&K 4,11,K&K 6,12,"A.P F 3,4",11,A.P F 5,66,119,25,22,47,166
560,52,"K&K 2,3,4,6",14,"K&K 2,3",8,K&K 4,15,K&K 6,15,"A.P F 3,4",11,A.P F 5,74,126,18,0,18,144
561,2,"K&K 2,3,4,6",0,"K&K 2,3",0,K&K 4,0,K&K 6,5,"A.P F 3,4",0,A.P F 5,7,9,2,0,2,11
562,19,"K&K 2,3,4,6",8,"K&K 2,3",15,K&K 4,15,K&K 6,4,"A.P F 3,4",15,A.P F 5,71,90,9,0,9,99
563,40,"K&K 2,3,4,6",3,"K&K 2,3",15,K&K 4,0,K&K 6,15,"A.P F 3,4",12,A.P F 5,60,100,11,3,14,114
564,0,"K&K 2,3,4,6",0,"K&K 2,3",12,K&K 4,2,K&K 6,9,"A.P F 3,4",1,A.P F 5,32,32,0,0,0,32
565,58,"K&K 2,3,4,6",12,"K&K 2,3",13,K&K 4,7,K&K 6,15,"A.P F 3,4",15,A.P F 5,74,132,17,13,30,162
566,26,"K&K 2,3,4,6",1,"K&K 2,3",0,K&K 4,0,K&K 6,0,"A.P F 3,4",6,A.P F 5,9,35,15,1,16,51
567,7,"K&K 2,3,4,6",5,"K&K 2,3",15,K&K 4,0,K&K 6,12,"A.P F 3,4",0,A.P F 5,43,50,0,0,0,50
568,57,"K&K 2,3,4,6",0,"K&K 2,3",5,K&K 4,15,K&K 6,15,"A.P F 3,4",12,A.P F 5,63,120,17,30,47,167
569,98,"K&K 2,3,4,6",15,"K&K 2,3",14,K&K 4,15,K&K 6,15,"A.P F 3,4",0,A.P F 5,79,177,44,30,74,251
570,41,"K&K 2,3,4,6",5,"K&K 2,3",15,K&K 4,8,K&K 6,0,"A.P F 3,4",15,A.P F 5,58,99,14,6,20,119
571,0,"K&K 2,3,4,6",0,"K&K 2,3",0,K&K 4,0,K&K 6,0,"A.P F 3,4",0,A.P F 5,0,0,0,0,0,0
572,15,"K&K 2,3,4,6",4,"K&K 2,3",9,K&K 4,15,K&K 6,13,"A.P F 3,4",11,A.P F 5,64,79,17,12,29,108
573,22,"K&K 2,3,4,6",6,"K&K 2,3",12,K&K 4,9,K&K 6,11,"A.P F 3,4",1,A.P F 5,51,73,10,2,12,85
574,93,"K&K 2,3,4,6",12,"K&K 2,3",14,K&K 4,11,K&K 6,15,"A.P F 3,4",6,A.P F 5,70,163,21,16,37,200
575,45,"K&K 2,3,4,6",12,"K&K 2,3",13,K&K 4,12,K&K 6,15,"A.P F 3,4",12,A.P F 5,70,115,13,12,25,140
576,14,"K&K 2,3,4,6",1,"K&K 2,3",1,K&K 4,2,K&K 6,0,"A.P F 3,4",3,A.P F 5,10,24,3,1,4,28
577,38,"K&K 2,3,4,6",0,"K&K 2,3",15,K&K 4,15,K&K 6,0,"A.P F 3,4",10,A.P F 5,54,92,9,9,18,110
578,30,"K&K 2,3,4,6",10,"K&K 2,3",9,K&K 4,3,K&K 6,6,"A.P F 3,4",3,A.P F 5,38,68,6,5,11,79
579,12,"K&K 2,3,4,6",4,"K&K 2,3",4,K&K 4,10,K&K 6,11,"A.P F 3,4",12,A.P F 5,50,62,13,3,16,78
580,34,"K&K 2,3,4,6",1,"K&K 2,3",11,K&K 4,4,K&K 6,4,"A.P F 3,4",11,A.P F 5,40,74,16,3,19,93
581,23,"K&K 2,3,4,6",15,"K&K 2,3",7,K&K 4,12,K&K 6,1,"A.P F 3,4",9,A.P F 5,58,81,8,0,8,89
582,86,"K&K 2,3,4,6",10,"K&K 2,3",15,K&K 4,15,K&K 6,11,"A.P F 3,4",15,A.P F 5,75,161,21,11,32,193
583,73,"K&K 2,3,4,6",11,"K&K 2,3",15,K&K 4,15,K&K 6,4,"A.P F 3,4",1,A.P F 5,60,133,29,23,52,185
584,0,"K&K 2,3,4,6",0,"K&K 2,3",0,K&K 4,0,K&K 6,0,"A.P F 3,4",0,A.P F 5,0,0,0,0,0,0
585,19,"K&K 2,3,4,6",1,"K&K 2,3",13,K&K 4,0,K&K 6,2,"A.P F 3,4",0,A.P F 5,22,41,15,2,17,58
586,21,"K&K 2,3,4,6",9,"K&K 2,3",9,K&K 4,0,K&K 6,4,"A.P F 3,4",10,A.P F 5,42,63,6,6,12,75
587,26,"K&K 2,3,4,6",12,"K&K 2,3",15,K&K 4,15,K&K 6,1,"A.P F 3,4",15,A.P F 5,76,102,13,9,22,124
588,19,"K&K 2,3,4,6",1,"K&K 2,3",0,K&K 4,0,K&K 6,4,"A.P F 3,4",0,A.P F 5,6,25,0,2,2,27
589,5,"K&K 2,3,4,6",0,"K&K 2,3",15,K&K 4,15,K&K 6,15,"A.P F 3,4",5,A.P F 5,67,72,2,3,5,77
590,13,"K&K 2,3,4,6",10,"K&K 2,3",1,K&K 4,4,K&K 6,4,"A.P F 3,4",1,A.P F 5,26,39,0,0,0,39
591,18,"K&K 2,3,4,6",4,"K&K 2,3",12,K&K 4,12,K&K 6,9,"A.P F 3,4",12,A.P F 5,60,78,6,5,11,89
592,43,"K&K 2,3,4,6",13,"K&K 2,3",10,K&K 4,4,K&K 6,0,"A.P F 3,4",0,A.P F 5,35,78,6,4,10,88
593,56,"K&K 2,3,4,6",0,"K&K 2,3",9,K&K 4,15,K&K 6,15,"A.P F 3,4",13,A.P F 5,70,126,22,5,27,153
594,24,"K&K 2,3,4,6",7,"K&K 2,3",10,K&K 4,0,K&K 6,0,"A.P F 3,4",3,A.P F 5,27,51,0,16,16,67
595,29,"K&K 2,3,4,6",3,"K&K 2,3",15,K&K 4,10,K&K 6,10,"A.P F 3,4",10,A.P F 5,60,89,4,4,8,97
596,8,"K&K 2,3,4,6",0,"K&K 2,3",3,K&K 4,0,K&K 6,0,"A.P F 3,4",0,A.P F 5,4,12,1,1,2,14
597,29,"K&K 2,3,4,6",0,"K&K 2,3",0,K&K 4,15,K&K 6,5,"A.P F 3,4",15,A.P F 5,47,76,0,3,3,79
598,30,"K&K 2,3,4,6",1,"K&K 2,3",15,K&K 4,15,K&K 6,8,"A.P F 3,4",0,A.P F 5,52,82,5,4,9,91
599,26,"K&K 2,3,4,6",1,"K&K 2,3",3,K&K 4,0,K&K 6,7,"A.P F 3,4",4,A.P F 5,20,46,0,2,2,48
600,32,"K&K 2,3,4,6",4,"K&K 2,3",8,K&K 4,15,K&K 6,15,"A.P F 3,4",15,A.P F 5,71,103,5,8,13,116
601,31,"K&K 2,3,4,6",4,"K&K 2,3",3,K&K 4,10,K&K 6,15,"A.P F 3,4",13,A.P F 5,56,87,6,27,33,120
602,12,"K&K 2,3,4,6",0,"K&K 2,3",9,K&K 4,2,K&K 6,0,"A.P F 3,4",5,A.P F 5,22,34,0,0,0,34
603,36,"K&K 2,3,4,6",4,"K&K 2,3",15,K&K 4,6,K&K 6,15,"A.P F 3,4",11,A.P F 5,63,99,6,13,19,118
604,27,"K&K 2,3,4,6",0,"K&K 2,3",7,K&K 4,0,K&K 6,0,"A.P F 3,4",5,A.P F 5,16,43,0,3,3,46
605,25,"K&K 2,3,4,6",1,"K&K 2,3",15,K&K 4,15,K&K 6,1,"A.P F 3,4",2,A.P F 5,44,69,8,7,14,83
606,29,"K&K 2,3,4,6",5,"K&K 2,3",15,K&K 4,0,K&K 6,7,"A.P F 3,4",15,A.P F 5,56,85,3,11,14,99
607,30,"K&K 2,3,4,6",0,"K&K 2,3",0,K&K 4,10,K&K 6,11,"A.P F 3,4",5,A.P F 5,35,65,2,9,11,76
608,33,"K&K 2,3,4,6",5,"K&K 2,3",0,K&K 4,2,K&K 6,0,"A.P F 3,4",6,A.P F 5,18,51,4,4,8,59
609,23,"K&K 2,3,4,6",1,"K&K 2,3",15,K&K 4,15,K&K 6,3,"A.P F 3,4",1,A.P F 5,46,69,4,11,15,84
610,47,"K&K 2,3,4,6",8,"K&K 2,3",15,K&K 4,2,K&K 6,13,"A.P F 3,4",15,A.P F 5,68,115,11,13,24,139
611,27,"K&K 2,3,4,6",2,"K&K 2,3",14,K&K 4,15,K&K 6,15,"A.P F 3,4",9,A.P F 5,71,98,2,17,19,117
612,2,"K&K 2,3,4,6",3,"K&K 2,3",0,K&K 4,0,K&K 6,7,"A.P F 3,4",1,A.P F 5,15,17,0,1,1,18
613,47,"K&K 2,3,4,6",15,"K&K 2,3",15,K&K 4,15,K&K 6,0,"A.P F 3,4",7,A.P F 5,70,117,13,6,18,135
614,29,"K&K 2,3,4,6",1,"K&K 2,3",0,K&K 4,12,K&K 6,1,"A.P F 3,4",9,A.P F 5,31,60,18,20,38,98
615,22,"K&K 2,3,4,6",15,"K&K 2,3",15,K&K 4,0,K&K 6,11,"A.P F 3,4",15,A.P F 5,75,97,0,19,19,116
616,40,"K&K 2,3,4,6",0,"K&K 2,3",8,K&K 4,3,K&K 6,4,"A.P F 3,4",0,A.P F 5,20,60,0,12,12,72
617,23,"K&K 2,3,4,6",0,"K&K 2,3",10,K&K 4,15,K&K 6,11,"A.P F 3,4",4,A.P F 5,53,76,4,1,5,81
618,22,"K&K 2,3,4,6",0,"K&K 2,3",15,K&K 4,15,K&K 6,5,"A.P F 3,4",2,A.P F 5,50,72,8,11,19,91
619,31,"K&K 2,3,4,6",10,"K&K 2,3",4,K&K 4,13,K&K 6,6,"A.P F 3,4",10,A.P F 5,52,83,12,9,21,104
620,37,"K&K 2,3,4,6",1,"K&K 2,3",12,K&K 4,15,K&K 6,10,"A.P F 3,4",4,A.P F 5,55,92,7,5,11,103
621,40,"K&K 2,3,4,6",15,"K&K 2,3",15,K&K 4,15,K&K 6,14,"A.P F 3,4",15,A.P F 5,80,120,24,46,70,190
622,30,"K&K 2,3,4,6",1,"K&K 2,3",15,K&K 4,15,K&K 6,15,"A.P F 3,4",11,A.P F 5,75,105,10,12,22,127
623,30,"K&K 2,3,4,6",10,"K&K 2,3",0,K&K 4,8,K&K 6,15,"A.P F 3,4",0,A.P F 5,44,74,1,5,6,80
624,35,"K&K 2,3,4,6",5,"K&K 2,3",0,K&K 4,2,K&K 6,10,"A.P F 3,4",3,A.P F 5,27,62,3,1,4,66
625,23,"K&K 2,3,4,6",5,"K&K 2,3",9,K&K 4,1,K&K 6,0,"A.P F 3,4",6,A.P F 5,28,51,3,3,6,57
626,38,"K&K 2,3,4,6",0,"K&K 2,3",14,K&K 4,0,K&K 6,0,"A.P F 3,4",4,A.P F 5,24,62,1,13,14,76
627,28,"K&K 2,3,4,6",1,"K&K 2,3",2,K&K 4,2,K&K 6,2,"A.P F 3,4",13,A.P F 5,26,54,1,11,12,66
628,32,"K&K 2,3,4,6",0,"K&K 2,3",7,K&K 4,1,K&K 6,11,"A.P F 3,4",7,A.P F 5,35,67,7,0,7,74
629,29,"K&K 2,3,4,6",5,"K&K 2,3",15,K&K 4,15,K&K 6,5,"A.P F 3,4",15,A.P F 5,67,96,6,26,32,128
630,34,"K&K 2,3,4,6",15,"K&K 2,3",15,K&K 4,10,K&K 6,15,"A.P F 3,4",8,A.P F 5,74,108,15,15,30,138
631,21,"K&K 2,3,4,6",5,"K&K 2,3",2,K&K 4,15,K&K 6,15,"A.P F 3,4",15,A.P F 5,67,88,7,7,14,102
632,23,"K&K 2,3,4,6",0,"K&K 2,3",4,K&K 4,10,K&K 6,0,"A.P F 3,4",10,A.P F 5,32,55,11,1,12,67
633,41,"K&K 2,3,4,6",1,"K&K 2,3",15,K&K 4,12,K&K 6,13,"A.P F 3,4",11,A.P F 5,68,109,12,5,17,126
634,23,"K&K 2,3,4,6",15,"K&K 2,3",3,K&K 4,2,K&K 6,1,"A.P F 3,4",6,A.P F 5,35,58,0,7,7,65
635,0,"K&K 2,3,4,6",3,"K&K 2,3",0,K&K 4,0,K&K 6,0,"A.P F 3,4",0,A.P F 5,4,4,0,0,0,4
636,44,"K&K 2,3,4,6",5,"K&K 2,3",0,K&K 4,4,K&K 6,8,"A.P F 3,4",0,A.P F 5,23,67,8,4,12,79
637,35,"K&K 2,3,4,6",0,"K&K 2,3",12,K&K 4,15,K&K 6,12,"A.P F 3,4",10,A.P F 5,66,101,12,2,14,115
638,20,"K&K 2,3,4,6",11,"K&K 2,3",0,K&K 4,0,K&K 6,2,"A.P F 3,4",3,A.P F 5,22,42,2,4,6,48
639,12,"K&K 2,3,4,6",0,"K&K 2,3",2,K&K 4,0,K&K 6,3,"A.P F 3,4",2,A.P F 5,10,22,5,0,5,27
640,29,"K&K 2,3,4,6",1,"K&K 2,3",7,K&K 4,0,K&K 6,1,"A.P F 3,4",0,A.P F 5,12,41,1,11,12,53
641,28,"K&K 2,3,4,6",1,"K&K 2,3",10,K&K 4,2,K&K 6,9,"A.P F 3,4",5,A.P F 5,35,63,1,23,24,87
642,10,"K&K 2,3,4,6",0,"K&K 2,3",0,K&K 4,15,K&K 6,0,"A.P F 3,4",8,A.P F 5,31,41,5,4,9,50
643,21,"K&K 2,3,4,6",1,"K&K 2,3",15,K&K 4,2,K&K 6,1,"A.P F 3,4",15,A.P F 5,44,65,0,15,15,80
644,41,"K&K 2,3,4,6",8,"K&K 2,3",15,K&K 4,5,K&K 6,12,"A.P F 3,4",15,A.P F 5,67,108,5,11,16,124
645,18,"K&K 2,3,4,6",5,"K&K 2,3",15,K&K 4,8,K&K 6,0,"A.P F 3,4",0,A.P F 5,38,56,3,7,10,66
646,29,"K&K 2,3,4,6",1,"K&K 2,3",5,K&K 4,1,K&K 6,7,"A.P F 3,4",7,A.P F 5,27,56,6,13,19,75
647,22,"K&K 2,3,4,6",0,"K&K 2,3",0,K&K 4,0,K&K 6,5,"A.P F 3,4",5,A.P F 5,14,36,2,0,2,38
648,4,"K&K 2,3,4,6",1,"K&K 2,3",1,K&K 4,0,K&K 6,0,"A.P F 3,4",0,A.P F 5,3,7,2,1,3,10
649,22,"K&K 2,3,4,6",0,"K&K 2,3",2,K&K 4,0,K&K 6,6,"A.P F 3,4",0,A.P F 5,11,33,3,3,6,39
650,44,"K&K 2,3,4,6",3,"K&K 2,3",15,K&K 4,8,K&K 6,12,"A.P F 3,4",15,A.P F 5,67,111,14,11,25,136
651,17,"K&K 2,3,4,6",1,"K&K 2,3",8,K&K 4,0,K&K 6,5,"A.P F 3,4",15,A.P F 5,39,56,5,9,14,70
652,17,"K&K 2,3,4,6",1,"K&K 2,3",8,K&K 4,2,K&K 6,1,"A.P F 3,4",1,A.P F 5,16,33,2,1,3,36
653,20,"K&K 2,3,4,6",1,"K&K 2,3",7,K&K 4,0,K&K 6,1,"A.P F 3,4",0,A.P F 5,12,32,4,3,7,39
654,20,"K&K 2,3,4,6",0,"K&K 2,3",2,K&K 4,9,K&K 6,12,"A.P F 3,4",15,A.P F 5,51,71,3,0,3,74
655,11,"K&K 2,3,4,6",9,"K&K 2,3",3,K&K 4,1,K&K 6,2,"A.P F 3,4",1,A.P F 5,20,31,3,20,23,54
656,5,"K&K 2,3,4,6",3,"K&K 2,3",15,K&K 4,1,K&K 6,14,"A.P F 3,4",5,A.P F 5,50,55,2,4,6,61
657,22,"K&K 2,3,4,6",1,"K&K 2,3",0,K&K 4,0,K&K 6,1,"A.P F 3,4",1,A.P F 5,4,26,0,9,9,35
658,28,"K&K 2,3,4,6",12,"K&K 2,3",3,K&K 4,1,K&K 6,5,"A.P F 3,4",5,A.P F 5,34,62,1,3,4,66
659,6,"K&K 2,3,4,6",0,"K&K 2,3",0,K&K 4,0,K&K 6,10,"A.P F 3,4",0,A.P F 5,14,20,10,7,17,37
660,31,"K&K 2,3,4,6",15,"K&K 2,3",13,K&K 4,15,K&K 6,15,"A.P F 3,4",15,A.P F 5,80,111,14,9,23,134
661,37,"K&K 2,3,4,6",0,"K&K 2,3",5,K&K 4,0,K&K 6,0,"A.P F 3,4",0,A.P F 5,7,44,5,6,11,55
662,15,"K&K 2,3,4,6",1,"K&K 2,3",3,K&K 4,3,K&K 6,2,"A.P F 3,4",0,A.P F 5,12,27,10,0,10,37
663,32,"K&K 2,3,4,6",1,"K&K 2,3",11,K&K 4,15,K&K 6,12,"A.P F 3,4",0,A.P F 5,52,84,3,2,5,89
664,41,"K&K 2,3,4,6",3,"K&K 2,3",8,K&K 4,0,K&K 6,0,"A.P F 3,4",15,A.P F 5,35,76,5,2,7,83
665,33,"K&K 2,3,4,6",0,"K&K 2,3",13,K&K 4,0,K&K 6,8,"A.P F 3,4",4,A.P F 5,33,66,3,1,4,70
666,46,"K&K 2,3,4,6",0,"K&K 2,3",0,K&K 4,0,K&K 6,15,"A.P F 3,4",8,A.P F 5,31,77,4,0,4,81
667,20,"K&K 2,3,4,6",0,"K&K 2,3",0,K&K 4,0,K&K 6,3,"A.P F 3,4",4,A.P F 5,10,30,4,8,12,42
668,34,"K&K 2,3,4,6",1,"K&K 2,3",1,K&K 4,6,K&K 6,9,"A.P F 3,4",15,A.P F 5,42,76,5,4,9,85
669,18,"K&K 2,3,4,6",0,"K&K 2,3",0,K&K 4,0,K&K 6,5,"A.P F 3,4",0,A.P F 5,7,25,5,1,6,31
670,11,"K&K 2,3,4,6",0,"K&K 2,3",5,K&K 4,0,K&K 6,0,"A.P F 3,4",15,A.P F 5,27,38,9,9,18,56
671,39,"K&K 2,3,4,6",1,"K&K 2,3",5,K&K 4,4,K&K 6,11,"A.P F 3,4",12,A.P F 5,43,82,9,3,12,94
672,8,"K&K 2,3,4,6",0,"K&K 2,3",0,K&K 4,0,K&K 6,12,"A.P F 3,4",0,A.P F 5,16,24,3,1,4,28
673,25,"K&K 2,3,4,6",1,"K&K 2,3",8,K&K 4,15,K&K 6,1,"A.P F 3,4",4,A.P F 5,38,63,0,4,4,67
674,39,"K&K 2,3,4,6",0,"K&K 2,3",10,K&K 4,0,K&K 6,12,"A.P F 3,4",0,A.P F 5,30,69,4,5,8,77
675,34,"K&K 2,3,4,6",14,"K&K 2,3",10,K&K 4,15,K&K 6,15,"A.P F 3,4",0,A.P F 5,72,106,9,18,27,133
676,33,"K&K 2,3,4,6",0,"K&K 2,3",6,K&K 4,2,K&K 6,0,"A.P F 3,4",14,A.P F 5,30,63,0,11,11,74
677,41,"K&K 2,3,4,6",13,"K&K 2,3",15,K&K 4,15,K&K 6,0,"A.P F 3,4",8,A.P F 5,68,109,12,18,29,138
678,60,"K&K 2,3,4,6",6,"K&K 2,3",9,K&K 4,15,K&K 6,11,"A.P F 3,4",8,A.P F 5,58,118,12,24,35,153
679,39,"K&K 2,3,4,6",1,"K&K 2,3",0,K&K 4,12,K&K 6,1,"A.P F 3,4",0,A.P F 5,19,58,5,0,5,63
680,12,"K&K 2,3,4,6",0,"K&K 2,3",0,K&K 4,0,K&K 6,6,"A.P F 3,4",8,A.P F 5,19,31,0,3,3,34
681,18,"K&K 2,3,4,6",0,"K&K 2,3",8,K&K 4,10,K&K 6,4,"A.P F 3,4",10,A.P F 5,43,61,0,3,3,64
682,0,"K&K 2,3,4,6",1,"K&K 2,3",7,K&K 4,0,K&K 6,0,"A.P F 3,4",1,A.P F 5,12,12,5,9,14,26
683,8,"K&K 2,3,4,6",0,"K&K 2,3",9,K&K 4,0,K&K 6,0,"A.P F 3,4",0,A.P F 5,12,20,0,7,7,27
684,49,"K&K 2,3,4,6",5,"K&K 2,3",13,K&K 4,15,K&K 6,15,"A.P F 3,4",15,A.P F 5,78,127,10,5,15,142
685,34,"K&K 2,3,4,6",15,"K&K 2,3",15,K&K 4,2,K&K 6,15,"A.P F 3,4",15,A.P F 5,80,114,11,4,14,128
686,28,"K&K 2,3,4,6",15,"K&K 2,3",15,K&K 4,0,K&K 6,3,"A.P F 3,4",11,A.P F 5,59,87,8,0,8,95
687,26,"K&K 2,3,4,6",1,"K&K 2,3",14,K&K 4,15,K&K 6,14,"A.P F 3,4",3,A.P F 5,62,88,4,2,6,94
688,10,"K&K 2,3,4,6",0,"K&K 2,3",14,K&K 4,12,K&K 6,9,"A.P F 3,4",15,A.P F 5,67,77,11,8,19,96
689,35,"K&K 2,3,4,6",1,"K&K 2,3",15,K&K 4,7,K&K 6,15,"A.P F 3,4",8,A.P F 5,60,95,16,19,35,130
690,34,"K&K 2,3,4,6",1,"K&K 2,3",15,K&K 4,15,K&K 6,12,"A.P F 3,4",15,A.P F 5,76,110,10,15,25,135
691,49,"K&K 2,3,4,6",0,"K&K 2,3",0,K&K 4,15,K&K 6,15,"A.P F 3,4",8,A.P F 5,51,100,10,3,13,113
692,27,"K&K 2,3,4,6",0,"K&K 2,3",1,K&K 4,2,K&K 6,5,"A.P F 3,4",0,A.P F 5,11,38,0,2,2,40
693,11,"K&K 2,3,4,6",0,"K&K 2,3",0,K&K 4,4,K&K 6,13,"A.P F 3,4",3,A.P F 5,27,38,0,21,21,59
694,63,"K&K 2,3,4,6",15,"K&K 2,3",12,K&K 4,15,K&K 6,15,"A.P F 3,4",15,A.P F 5,80,143,9,0,9,152
695,28,"K&K 2,3,4,6",1,"K&K 2,3",8,K&K 4,0,K&K 6,0,"A.P F 3,4",0,A.P F 5,12,40,2,25,27,67
696,27,"K&K 2,3,4,6",15,"K&K 2,3",15,K&K 4,15,K&K 6,13,"A.P F 3,4",0,A.P F 5,78,105,5,4,9,114
697,27,"K&K 2,3,4,6",10,"K&K 2,3",0,K&K 4,12,K&K 6,0,"A.P F 3,4",8,A.P F 5,40,67,8,12,20,87
698,41,"K&K 2,3,4,6",6,"K&K 2,3",15,K&K 4,15,K&K 6,15,"A.P F 3,4",15,A.P F 5,80,121,29,15,44,165
699,14,"K&K 2,3,4,6",1,"K&K 2,3",1,K&K 4,1,K&K 6,5,"A.P F 3,4",14,A.P F 5,28,42,7,3,10,52
700,21,"K&K 2,3,4,6",0,"K&K 2,3",12,K&K 4,7,K&K 6,7,"A.P F 3,4",15,A.P F 5,55,76,7,2,9,85
701,11,"K&K 2,3,4,6",0,"K&K 2,3",0,K&K 4,0,K&K 6,0,"A.P F 3,4",0,A.P F 5,0,11,0,6,6,17
702,30,"K&K 2,3,4,6",11,"K&K 2,3",7,K&K 4,2,K&K 6,9,"A.P F 3,4",0,A.P F 5,39,69,6,1,7,76
703,19,"K&K 2,3,4,6",0,"K&K 2,3",0,K&K 4,0,K&K 6,0,"A.P F 3,4",0,A.P F 5,0,19,6,3,9,28
704,13,"K&K 2,3,4,6",0,"K&K 2,3",5,K&K 4,2,K&K 6,0,"A.P F 3,4",0,A.P F 5,10,23,1,1,2,25
705,36,"K&K 2,3,4,6",0,"K&K 2,3",13,K&K 4,8,K&K 6,5,"A.P F 3,4",15,A.P F 5,55,91,7,3,10,101
706,29,"K&K 2,3,4,6",0,"K&K 2,3",0,K&K 4,0,K&K 6,0,"A.P F 3,4",0,A.P F 5,0,29,2,3,5,34
707,20,"K&K 2,3,4,6",8,"K&K 2,3",1,K&K 4,15,K&K 6,14,"A.P F 3,4",15,A.P F 5,70,90,10,6,16,106
708,29,"K&K 2,3,4,6",0,"K&K 2,3",9,K&K 4,6,K&K 6,11,"A.P F 3,4",0,A.P F 5,35,64,5,10,15,79
709,41,"K&K 2,3,4,6",5,"K&K 2,3",15,K&K 4,10,K&K 6,4,"A.P F 3,4",15,A.P F 5,60,101,17,25,42,143
710,8,"K&K 2,3,4,6",2,"K&K 2,3",15,K&K 4,15,K&K 6,10,"A.P F 3,4",15,A.P F 5,74,82,6,10,16,98
711,31,"K&K 2,3,4,6",15,"K&K 2,3",15,K&K 4,13,K&K 6,12,"A.P F 3,4",12,A.P F 5,74,105,18,4,22,127
712,35,"K&K 2,3,4,6",12,"K&K 2,3",13,K&K 4,15,K&K 6,15,"A.P F 3,4",15,A.P F 5,78,113,18,12,30,143
713,23,"K&K 2,3,4,6",4,"K&K 2,3",15,K&K 4,15,K&K 6,0,"A.P F 3,4",10,A.P F 5,59,82,9,46,55,137
714,51,"K&K 2,3,4,6",15,"K&K 2,3",15,K&K 4,10,K&K 6,14,"A.P F 3,4",0,A.P F 5,72,123,15,15,29,152
715,37,"K&K 2,3,4,6",0,"K&K 2,3",15,K&K 4,12,K&K 6,11,"A.P F 3,4",2,A.P F 5,54,91,6,9,14,105
716,49,"K&K 2,3,4,6",15,"K&K 2,3",15,K&K 4,11,K&K 6,15,"A.P F 3,4",0,A.P F 5,75,124,10,9,19,143
717,35,"K&K 2,3,4,6",3,"K&K 2,3",14,K&K 4,10,K&K 6,7,"A.P F 3,4",3,A.P F 5,46,81,7,25,32,113
718,45,"K&K 2,3,4,6",1,"K&K 2,3",15,K&K 4,12,K&K 6,13,"A.P F 3,4",15,A.P F 5,74,119,13,24,37,156
719,36,"K&K 2,3,4,6",15,"K&K 2,3",15,K&K 4,15,K&K 6,15,"A.P F 3,4",0,A.P F 5,80,116,17,9,26,142
720,71,"K&K 2,3,4,6",15,"K&K 2,3",15,K&K 4,15,K&K 6,15,"A.P F 3,4",14,A.P F 5,80,151,38,59,97,248
721,43,"K&K 2,3,4,6",0,"K&K 2,3",8,K&K 4,3,K&K 6,5,"A.P F 3,4",12,A.P F 5,38,81,4,1,5,86
722,23,"K&K 2,3,4,6",7,"K&K 2,3",5,K&K 4,12,K&K 6,8,"A.P F 3,4",3,A.P F 5,43,66,2,14,16,82
723,46,"K&K 2,3,4,6",2,"K&K 2,3",15,K&K 4,5,K&K 6,15,"A.P F 3,4",15,A.P F 5,67,113,6,17,23,136
724,31,"K&K 2,3,4,6",1,"K&K 2,3",15,K&K 4,3,K&K 6,15,"A.P F 3,4",15,A.P F 5,64,95,14,9,23,118
725,34,"K&K 2,3,4,6",1,"K&K 2,3",11,K&K 4,12,K&K 6,15,"A.P F 3,4",6,A.P F 5,59,93,3,8,10,103
726,37,"K&K 2,3,4,6",1,"K&K 2,3",7,K&K 4,8,K&K 6,15,"A.P F 3,4",15,A.P F 5,60,97,8,43,51,148
727,29,"K&K 2,3,4,6",10,"K&K 2,3",15,K&K 4,1,K&K 6,3,"A.P F 3,4",3,A.P F 5,42,71,4,3,6,77
728,37,"K&K 2,3,4,6",0,"K&K 2,3",13,K&K 4,15,K&K 6,15,"A.P F 3,4",4,A.P F 5,63,100,12,19,31,131
729,24,"K&K 2,3,4,6",2,"K&K 2,3",6,K&K 4,0,K&K 6,4,"A.P F 3,4",5,A.P F 5,23,47,11,10,21,68
730,38,"K&K 2,3,4,6",5,"K&K 2,3",15,K&K 4,15,K&K 6,15,"A.P F 3,4",8,A.P F 5,71,109,19,9,28,137
731,24,"K&K 2,3,4,6",0,"K&K 2,3",15,K&K 4,0,K&K 6,15,"A.P F 3,4",4,A.P F 5,46,70,4,12,16,86
732,61,"K&K 2,3,4,6",10,"K&K 2,3",0,K&K 4,15,K&K 6,12,"A.P F 3,4",15,A.P F 5,70,131,17,5,22,153
733,37,"K&K 2,3,4,6",10,"K&K 2,3",15,K&K 4,15,K&K 6,10,"A.P F 3,4",15,A.P F 5,74,111,8,9,17,128
734,25,"K&K 2,3,4,6",6,"K&K 2,3",15,K&K 4,4,K&K 6,8,"A.P F 3,4",15,A.P F 5,59,84,9,6,15,99
735,34,"K&K 2,3,4,6",15,"K&K 2,3",15,K&K 4,0,K&K 6,15,"A.P F 3,4",0,A.P F 5,60,94,0,6,6,100
736,18,"K&K 2,3,4,6",10,"K&K 2,3",10,K&K 4,0,K&K 6,14,"A.P F 3,4",6,A.P F 5,53,71,5,5,10,81
737,34,"K&K 2,3,4,6",13,"K&K 2,3",15,K&K 4,15,K&K 6,15,"A.P F 3,4",8,A.P F 5,78,112,18,6,24,136
738,18,"K&K 2,3,4,6",15,"K&K 2,3",12,K&K 4,15,K&K 6,15,"A.P F 3,4",15,A.P F 5,80,98,6,18,24,122
739,67,"K&K 2,3,4,6",14,"K&K 2,3",15,K&K 4,15,K&K 6,0,"A.P F 3,4",0,A.P F 5,59,126,11,10,21,147
740,42,"K&K 2,3,4,6",5,"K&K 2,3",14,K&K 4,15,K&K 6,15,"A.P F 3,4",15,A.P F 5,79,121,12,10,22,143
741,11,"K&K 2,3,4,6",15,"K&K 2,3",8,K&K 4,0,K&K 6,8,"A.P F 3,4",15,A.P F 5,62,73,15,5,20,93
742,20,"K&K 2,3,4,6",2,"K&K 2,3",7,K&K 4,1,K&K 6,6,"A.P F 3,4",3,A.P F 5,24,44,1,9,10,54
743,41,"K&K 2,3,4,6",2,"K&K 2,3",11,K&K 4,2,K&K 6,6,"A.P F 3,4",0,A.P F 5,28,69,5,1,6,75
744,25,"K&K 2,3,4,6",11,"K&K 2,3",9,K&K 4,15,K&K 6,6,"A.P F 3,4",3,A.P F 5,55,80,13,12,25,105
745,33,"K&K 2,3,4,6",15,"K&K 2,3",11,K&K 4,2,K&K 6,4,"A.P F 3,4",2,A.P F 5,43,76,6,7,12,88
746,36,"K&K 2,3,4,6",5,"K&K 2,3",10,K&K 4,15,K&K 6,10,"A.P F 3,4",14,A.P F 5,66,102,16,2,18,120
747,43,"K&K 2,3,4,6",0,"K&K 2,3",12,K&K 4,8,K&K 6,15,"A.P F 3,4",0,A.P F 5,47,90,5,10,15,105
748,30,"K&K 2,3,4,6",7,"K&K 2,3",0,K&K 4,10,K&K 6,13,"A.P F 3,4",2,A.P F 5,43,73,5,22,27,100
749,45,"K&K 2,3,4,6",5,"K&K 2,3",15,K&K 4,15,K&K 6,15,"A.P F 3,4",15,A.P F 5,80,125,14,15,28,153
750,37,"K&K 2,3,4,6",12,"K&K 2,3",15,K&K 4,15,K&K 6,13,"A.P F 3,4",13,A.P F 5,75,112,11,12,23,135
751,30,"K&K 2,3,4,6",3,"K&K 2,3",5,K&K 4,13,K&K 6,5,"A.P F 3,4",15,A.P F 5,51,81,14,12,26,107
752,34,"K&K 2,3,4,6",15,"K&K 2,3",15,K&K 4,0,K&K 6,6,"A.P F 3,4",0,A.P F 5,48,82,6,18,24,106
753,39,"K&K 2,3,4,6",3,"K&K 2,3",7,K&K 4,0,K&K 6,7,"A.P F 3,4",4,A.P F 5,28,67,6,14,20,87
754,34,"K&K 2,3,4,6",0,"K&K 2,3",0,K&K 4,5,K&K 6,0,"A.P F 3,4",15,A.P F 5,27,61,4,4,8,69
755,35,"K&K 2,3,4,6",0,"K&K 2,3",7,K&K 4,3,K&K 6,8,"A.P F 3,4",15,A.P F 5,44,79,6,1,7,86
756,4,"K&K 2,3,4,6",0,"K&K 2,3",15,K&K 4,2,K&K 6,2,"A.P F 3,4",15,A.P F 5,46,50,6,43,49,99
757,27,"K&K 2,3,4,6",4,"K&K 2,3",15,K&K 4,15,K&K 6,5,"A.P F 3,4",1,A.P F 5,52,79,2,4,6,85
758,35,"K&K 2,3,4,6",0,"K&K 2,3",12,K&K 4,0,K&K 6,5,"A.P F 3,4",0,A.P F 5,23,58,14,8,22,80
759,28,"K&K 2,3,4,6",5,"K&K 2,3",15,K&K 4,1,K&K 6,6,"A.P F 3,4",5,A.P F 5,42,70,9,28,37,107
760,18,"K&K 2,3,4,6",0,"K&K 2,3",0,K&K 4,0,K&K 6,14,"A.P F 3,4",8,A.P F 5,30,48,6,11,17,65
761,35,"K&K 2,3,4,6",0,"K&K 2,3",10,K&K 4,0,K&K 6,7,"A.P F 3,4",5,A.P F 5,29,64,4,5,9,73
762,16,"K&K 2,3,4,6",1,"K&K 2,3",0,K&K 4,0,K&K 6,1,"A.P F 3,4",3,A.P F 5,7,23,4,2,6,29
763,2,"K&K 2,3,4,6",0,"K&K 2,3",15,K&K 4,0,K&K 6,15,"A.P F 3,4",4,A.P F 5,46,48,4,0,4,52
764,27,"K&K 2,3,4,6",1,"K&K 2,3",15,K&K 4,2,K&K 6,10,"A.P F 3,4",11,A.P F 5,51,78,4,4,8,86
765,37,"K&K 2,3,4,6",9,"K&K 2,3",0,K&K 4,2,K&K 6,15,"A.P F 3,4",15,A.P F 5,55,92,3,1,4,96
766,0,"K&K 2,3,4,6",0,"K&K 2,3",7,K&K 4,0,K&K 6,10,"A.P F 3,4",0,A.P F 5,22,22,0,0,0,22
767,30,"K&K 2,3,4,6",1,"K&K 2,3",15,K&K 4,15,K&K 6,13,"A.P F 3,4",0,A.P F 5,59,89,6,4,10,99
768,11,"K&K 2,3,4,6",0,"K&K 2,3",4,K&K 4,0,K&K 6,6,"A.P F 3,4",0,A.P F 5,14,25,4,0,4,29
769,35,"K&K 2,3,4,6",4,"K&K 2,3",9,K&K 4,15,K&K 6,12,"A.P F 3,4",13,A.P F 5,66,101,6,22,28,129
770,41,"K&K 2,3,4,6",5,"K&K 2,3",15,K&K 4,9,K&K 6,9,"A.P F 3,4",11,A.P F 5,59,100,6,12,18,118
771,2,"K&K 2,3,4,6",1,"K&K 2,3",15,K&K 4,8,K&K 6,3,"A.P F 3,4",12,A.P F 5,51,53,5,0,5,58
772,25,"K&K 2,3,4,6",5,"K&K 2,3",4,K&K 4,2,K&K 6,4,"A.P F 3,4",15,A.P F 5,38,63,0,4,4,67
773,32,"K&K 2,3,4,6",2,"K&K 2,3",15,K&K 4,10,K&K 6,13,"A.P F 3,4",15,A.P F 5,71,103,7,9,16,119
774,32,"K&K 2,3,4,6",10,"K&K 2,3",0,K&K 4,4,K&K 6,0,"A.P F 3,4",15,A.P F 5,39,71,6,24,30,101
775,21,"K&K 2,3,4,6",0,"K&K 2,3",4,K&K 4,0,K&K 6,13,"A.P F 3,4",0,A.P F 5,23,44,4,2,6,50
776,30,"K&K 2,3,4,6",0,"K&K 2,3",0,K&K 4,10,K&K 6,0,"A.P F 3,4",15,A.P F 5,34,64,5,0,5,69
777,16,"K&K 2,3,4,6",2,"K&K 2,3",15,K&K 4,1,K&K 6,15,"A.P F 3,4",13,A.P F 5,60,76,2,7,9,85
778,7,"K&K 2,3,4,6",1,"K&K 2,3",0,K&K 4,0,K&K 6,0,"A.P F 3,4",0,A.P F 5,2,9,1,6,7,16
779,13,"K&K 2,3,4,6",5,"K&K 2,3",1,K&K 4,0,K&K 6,13,"A.P F 3,4",9,A.P F 5,38,51,0,1,1,52
780,33,"K&K 2,3,4,6",0,"K&K 2,3",6,K&K 4,2,K&K 6,8,"A.P F 3,4",7,A.P F 5,30,63,3,2,5,68
781,16,"K&K 2,3,4,6",0,"K&K 2,3",5,K&K 4,0,K&K 6,0,"A.P F 3,4",0,A.P F 5,7,23,2,5,7,30
782,28,"K&K 2,3,4,6",15,"K&K 2,3",10,K&K 4,0,K&K 6,15,"A.P F 3,4",15,A.P F 5,74,102,1,5,6,108
783,6,"K&K 2,3,4,6",4,"K&K 2,3",11,K&K 4,2,K&K 6,2,"A.P F 3,4",6,A.P F 5,31,37,8,15,22,59
784,10,"K&K 2,3,4,6",5,"K&K 2,3",0,K&K 4,0,K&K 6,0,"A.P F 3,4",5,A.P F 5,14,24,4,3,7,31
785,17,"K&K 2,3,4,6",1,"K&K 2,3",1,K&K 4,1,K&K 6,8,"A.P F 3,4",4,A.P F 5,19,36,1,11,12,48
786,20,"K&K 2,3,4,6",5,"K&K 2,3",6,K&K 4,0,K&K 6,0,"A.P F 3,4",5,A.P F 5,22,42,3,15,18,60
787,30,"K&K 2,3,4,6",0,"K&K 2,3",0,K&K 4,0,K&K 6,3,"A.P F 3,4",5,A.P F 5,11,41,4,7,11,52
788,2,"K&K 2,3,4,6",3,"K&K 2,3",0,K&K 4,0,K&K 6,0,"A.P F 3,4",0,A.P F 5,4,6,0,1,1,7
789,32,"K&K 2,3,4,6",5,"K&K 2,3",8,K&K 4,8,K&K 6,15,"A.P F 3,4",10,A.P F 5,55,87,13,17,30,117
790,53,"K&K 2,3,4,6",15,"K&K 2,3",15,K&K 4,15,K&K 6,2,"A.P F 3,4",7,A.P F 5,70,123,10,42,52,175
791,41,"K&K 2,3,4,6",2,"K&K 2,3",11,K&K 4,15,K&K 6,15,"A.P F 3,4",1,A.P F 5,58,99,17,12,29,128
792,37,"K&K 2,3,4,6",1,"K&K 2,3",11,K&K 4,15,K&K 6,10,"A.P F 3,4",6,A.P F 5,56,93,10,6,16,109
793,40,"K&K 2,3,4,6",10,"K&K 2,3",15,K&K 4,15,K&K 6,15,"A.P F 3,4",8,A.P F 5,74,114,10,11,20,134
794,20,"K&K 2,3,4,6",2,"K&K 2,3",0,K&K 4,1,K&K 6,6,"A.P F 3,4",7,A.P F 5,22,42,0,5,5,47
795,21,"K&K 2,3,4,6",3,"K&K 2,3",11,K&K 4,8,K&K 6,0,"A.P F 3,4",9,A.P F 5,42,63,8,12,20,83
796,29,"K&K 2,3,4,6",3,"K&K 2,3",2,K&K 4,2,K&K 6,3,"A.P F 3,4",8,A.P F 5,22,51,11,10,21,72
797,20,"K&K 2,3,4,6",12,"K&K 2,3",10,K&K 4,0,K&K 6,10,"A.P F 3,4",15,A.P F 5,63,83,2,9,10,93
798,31,"K&K 2,3,4,6",15,"K&K 2,3",10,K&K 4,15,K&K 6,10,"A.P F 3,4",6,A.P F 5,67,98,2,9,11,109
799,63,"K&K 2,3,4,6",15,"K&K 2,3",15,K&K 4,15,K&K 6,15,"A.P F 3,4",15,A.P F 5,80,143,22,10,32,175
800,31,"K&K 2,3,4,6",5,"K&K 2,3",15,K&K 4,5,K&K 6,15,"A.P F 3,4",15,A.P F 5,67,98,24,14,37,135
801,46,"K&K 2,3,4,6",15,"K&K 2,3",8,K&K 4,15,K&K 6,15,"A.P F 3,4",15,A.P F 5,80,126,19,13,31,157
802,38,"K&K 2,3,4,6",14,"K&K 2,3",15,K&K 4,15,K&K 6,12,"A.P F 3,4",0,A.P F 5,75,113,9,31,40,153
803,31,"K&K 2,3,4,6",9,"K&K 2,3",15,K&K 4,15,K&K 6,15,"A.P F 3,4",13,A.P F 5,78,109,12,13,25,134
804,16,"K&K 2,3,4,6",0,"K&K 2,3",0,K&K 4,0,K&K 6,0,"A.P F 3,4",0,A.P F 5,0,16,2,0,2,18
805,30,"K&K 2,3,4,6",3,"K&K 2,3",15,K&K 4,1,K&K 6,4,"A.P F 3,4",1,A.P F 5,31,61,10,2,12,73
806,36,"K&K 2,3,4,6",5,"K&K 2,3",6,K&K 4,10,K&K 6,15,"A.P F 3,4",15,A.P F 5,62,98,8,12,20,118
807,39,"K&K 2,3,4,6",14,"K&K 2,3",10,K&K 4,0,K&K 6,15,"A.P F 3,4",12,A.P F 5,68,107,0,16,16,123
808,24,"K&K 2,3,4,6",1,"K&K 2,3",7,K&K 4,15,K&K 6,13,"A.P F 3,4",8,A.P F 5,58,82,5,8,13,95
809,52,"K&K 2,3,4,6",15,"K&K 2,3",15,K&K 4,15,K&K 6,15,"A.P F 3,4",0,A.P F 5,80,132,29,10,39,171
810,41,"K&K 2,3,4,6",10,"K&K 2,3",8,K&K 4,15,K&K 6,15,"A.P F 3,4",3,A.P F 5,64,105,9,15,24,129
811,7,"K&K 2,3,4,6",3,"K&K 2,3",9,K&K 4,3,K&K 6,8,"A.P F 3,4",7,A.P F 5,36,43,7,8,15,58
812,26,"K&K 2,3,4,6",9,"K&K 2,3",12,K&K 4,8,K&K 6,5,"A.P F 3,4",0,A.P F 5,46,72,3,5,8,80
813,52,"K&K 2,3,4,6",3,"K&K 2,3",15,K&K 4,15,K&K 6,7,"A.P F 3,4",15,A.P F 5,70,122,4,13,17,139
814,28,"K&K 2,3,4,6",4,"K&K 2,3",7,K&K 4,7,K&K 6,6,"A.P F 3,4",11,A.P F 5,42,70,16,21,36,106
815,38,"K&K 2,3,4,6",5,"K&K 2,3",15,K&K 4,15,K&K 6,0,"A.P F 3,4",5,A.P F 5,54,92,14,8,22,114
816,27,"K&K 2,3,4,6",0,"K&K 2,3",13,K&K 4,10,K&K 6,2,"A.P F 3,4",15,A.P F 5,54,81,8,7,15,96
817,27,"K&K 2,3,4,6",8,"K&K 2,3",12,K&K 4,15,K&K 6,15,"A.P F 3,4",15,A.P F 5,76,103,11,9,20,123
818,21,"K&K 2,3,4,6",7,"K&K 2,3",10,K&K 4,8,K&K 6,2,"A.P F 3,4",15,A.P F 5,54,75,0,3,3,78
819,40,"K&K 2,3,4,6",1,"K&K 2,3",15,K&K 4,15,K&K 6,11,"A.P F 3,4",15,A.P F 5,75,115,11,6,17,132
820,50,"K&K 2,3,4,6",2,"K&K 2,3",15,K&K 4,1,K&K 6,5,"A.P F 3,4",15,A.P F 5,50,100,18,13,30,130
821,36,"K&K 2,3,4,6",0,"K&K 2,3",15,K&K 4,15,K&K 6,15,"A.P F 3,4",0,A.P F 5,60,96,8,25,33,129
822,24,"K&K 2,3,4,6",1,"K&K 2,3",7,K&K 4,4,K&K 6,9,"A.P F 3,4",2,A.P F 5,30,54,5,10,15,69
823,19,"K&K 2,3,4,6",13,"K&K 2,3",0,K&K 4,0,K&K 6,15,"A.P F 3,4",15,A.P F 5,58,77,5,6,11,88
824,24,"K&K 2,3,4,6",0,"K&K 2,3",0,K&K 4,0,K&K 6,5,"A.P F 3,4",5,A.P F 5,14,38,4,5,9,47
825,22,"K&K 2,3,4,6",10,"K&K 2,3",0,K&K 4,0,K&K 6,8,"A.P F 3,4",12,A.P F 5,40,62,0,0,0,62
826,49,"K&K 2,3,4,6",4,"K&K 2,3",15,K&K 4,15,K&K 6,8,"A.P F 3,4",12,A.P F 5,67,116,19,9,27,143
827,18,"K&K 2,3,4,6",10,"K&K 2,3",15,K&K 4,3,K&K 6,15,"A.P F 3,4",9,A.P F 5,66,84,10,7,17,101
828,23,"K&K 2,3,4,6",11,"K&K 2,3",12,K&K 4,15,K&K 6,3,"A.P F 3,4",13,A.P F 5,68,91,2,10,12,103
829,25,"K&K 2,3,4,6",3,"K&K 2,3",11,K&K 4,12,K&K 6,4,"A.P F 3,4",5,A.P F 5,43,68,12,4,16,84
830,27,"K&K 2,3,4,6",2,"K&K 2,3",0,K&K 4,0,K&K 6,15,"A.P F 3,4",15,A.P F 5,43,70,11,3,14,84
831,38,"K&K 2,3,4,6",0,"K&K 2,3",12,K&K 4,15,K&K 6,15,"A.P F 3,4",15,A.P F 5,76,114,0,0,0,114
832,15,"K&K 2,3,4,6",0,"K&K 2,3",7,K&K 4,0,K&K 6,4,"A.P F 3,4",7,A.P F 5,24,39,14,10,24,63
833,29,"K&K 2,3,4,6",0,"K&K 2,3",9,K&K 4,1,K&K 6,6,"A.P F 3,4",7,A.P F 5,31,60,1,4,5,65
834,42,"K&K 2,3,4,6",5,"K&K 2,3",14,K&K 4,15,K&K 6,12,"A.P F 3,4",11,A.P F 5,70,112,7,42,49,161
835,49,"K&K 2,3,4,6",10,"K&K 2,3",8,K&K 4,15,K&K 6,5,"A.P F 3,4",5,A.P F 5,51,100,3,6,9,109
836,57,"K&K 2,3,4,6",5,"K&K 2,3",0,K&K 4,15,K&K 6,7,"A.P F 3,4",8,A.P F 5,47,104,16,5,21,125
837,37,"K&K 2,3,4,6",5,"K&K 2,3",9,K&K 4,15,K&K 6,14,"A.P F 3,4",15,A.P F 5,71,108,12,10,22,130
838,43,"K&K 2,3,4,6",1,"K&K 2,3",15,K&K 4,15,K&K 6,5,"A.P F 3,4",15,A.P F 5,67,110,3,4,7,117
839,19,"K&K 2,3,4,6",3,"K&K 2,3",15,K&K 4,11,K&K 6,10,"A.P F 3,4",15,A.P F 5,68,87,0,21,21,108
840,34,"K&K 2,3,4,6",0,"K&K 2,3",1,K&K 4,0,K&K 6,1,"A.P F 3,4",0,A.P F 5,3,37,5,6,11,48
841,27,"K&K 2,3,4,6",0,"K&K 2,3",8,K&K 4,2,K&K 6,6,"A.P F 3,4",3,A.P F 5,26,53,5,6,11,64
842,14,"K&K 2,3,4,6",1,"K&K 2,3",15,K&K 4,9,K&K 6,2,"A.P F 3,4",13,A.P F 5,52,66,7,5,12,78
843,22,"K&K 2,3,4,6",3,"K&K 2,3",15,K&K 4,15,K&K 6,11,"A.P F 3,4",11,A.P F 5,70,92,8,5,13,105
844,31,"K&K 2,3,4,6",7,"K&K 2,3",6,K&K 4,14,K&K 6,7,"A.P F 3,4",0,A.P F 5,46,77,9,9,18,95
845,9,"K&K 2,3,4,6",0,"K&K 2,3",15,K&K 4,15,K&K 6,15,"A.P F 3,4",15,A.P F 5,80,89,0,0,0,89
846,50,"K&K 2,3,4,6",2,"K&K 2,3",8,K&K 4,1,K&K 6,11,"A.P F 3,4",15,A.P F 5,48,98,11,4,15,113
847,46,"K&K 2,3,4,6",15,"K&K 2,3",9,K&K 4,15,K&K 6,7,"A.P F 3,4",8,A.P F 5,63,109,10,18,28,137
848,51,"K&K 2,3,4,6",5,"K&K 2,3",0,K&K 4,15,K&K 6,15,"A.P F 3,4",15,A.P F 5,67,118,5,9,14,132
849,8,"K&K 2,3,4,6",5,"K&K 2,3",8,K&K 4,5,K&K 6,0,"A.P F 3,4",6,A.P F 5,32,40,3,6,9,49
850,20,"K&K 2,3,4,6",1,"K&K 2,3",11,K&K 4,3,K&K 6,5,"A.P F 3,4",0,A.P F 5,27,47,1,1,2,49
851,38,"K&K 2,3,4,6",0,"K&K 2,3",15,K&K 4,15,K&K 6,0,"A.P F 3,4",5,A.P F 5,47,85,5,3,8,93
852,28,"K&K 2,3,4,6",13,"K&K 2,3",0,K&K 4,4,K&K 6,3,"A.P F 3,4",14,A.P F 5,46,74,12,4,16,90
853,25,"K&K 2,3,4,6",1,"K&K 2,3",10,K&K 4,10,K&K 6,1,"A.P F 3,4",12,A.P F 5,44,69,7,0,7,76
854,38,"K&K 2,3,4,6",12,"K&K 2,3",13,K&K 4,15,K&K 6,15,"A.P F 3,4",15,A.P F 5,78,116,5,19,24,140
855,16,"K&K 2,3,4,6",1,"K&K 2,3",0,K&K 4,1,K&K 6,0,"A.P F 3,4",1,A.P F 5,4,20,3,0,3,23
856,26,"K&K 2,3,4,6",1,"K&K 2,3",15,K&K 4,12,K&K 6,10,"A.P F 3,4",0,A.P F 5,51,77,5,9,14,91
857,17,"K&K 2,3,4,6",1,"K&K 2,3",0,K&K 4,0,K&K 6,1,"A.P F 3,4",0,A.P F 5,3,20,1,0,1,21
858,13,"K&K 2,3,4,6",2,"K&K 2,3",0,K&K 4,0,K&K 6,12,"A.P F 3,4",5,A.P F 5,26,39,5,10,15,54
859,20,"K&K 2,3,4,6",1,"K&K 2,3",2,K&K 4,0,K&K 6,7,"A.P F 3,4",15,A.P F 5,34,54,2,7,9,63
860,27,"K&K 2,3,4,6",2,"K&K 2,3",15,K&K 4,6,K&K 6,15,"A.P F 3,4",15,A.P F 5,68,95,9,14,23,118
861,22,"K&K 2,3,4,6",10,"K&K 2,3",0,K&K 4,4,K&K 6,5,"A.P F 3,4",0,A.P F 5,26,48,7,3,10,58
862,16,"K&K 2,3,4,6",0,"K&K 2,3",7,K&K 4,6,K&K 6,8,"A.P F 3,4",15,A.P F 5,48,64,1,6,7,71
863,28,"K&K 2,3,4,6",0,"K&K 2,3",2,K&K 4,2,K&K 6,10,"A.P F 3,4",7,A.P F 5,28,56,0,0,0,56
864,0,"K&K 2,3,4,6",1,"K&K 2,3",1,K&K 4,1,K&K 6,1,"A.P F 3,4",0,A.P F 5,6,6,0,0,0,6
865,28,"K&K 2,3,4,6",13,"K&K 2,3",0,K&K 4,2,K&K 6,10,"A.P F 3,4",5,A.P F 5,40,68,8,10,18,86
866,34,"K&K 2,3,4,6",0,"K&K 2,3",3,K&K 4,0,K&K 6,11,"A.P F 3,4",4,A.P F 5,23,57,3,1,4,61
867,26,"K&K 2,3,4,6",0,"K&K 2,3",7,K&K 4,0,K&K 6,15,"A.P F 3,4",2,A.P F 5,32,58,0,10,10,68
868,4,"K&K 2,3,4,6",0,"K&K 2,3",0,K&K 4,0,K&K 6,0,"A.P F 3,4",0,A.P F 5,0,4,0,0,0,4
869,23,"K&K 2,3,4,6",4,"K&K 2,3",15,K&K 4,0,K&K 6,11,"A.P F 3,4",10,A.P F 5,54,77,4,9,13,90
870,1,"K&K 2,3,4,6",1,"K&K 2,3",15,K&K 4,1,K&K 6,1,"A.P F 3,4",3,A.P F 5,27,28,0,0,0,28
871,4,"K&K 2,3,4,6",0,"K&K 2,3",0,K&K 4,0,K&K 6,1,"A.P F 3,4",3,A.P F 5,6,10,0,4,4,14
872,6,"K&K 2,3,4,6",0,"K&K 2,3",10,K&K 4,0,K&K 6,6,"A.P F 3,4",3,A.P F 5,26,32,0,1,1,33
873,3,"K&K 2,3,4,6",1,"K&K 2,3",1,K&K 4,2,K&K 6,14,"A.P F 3,4",15,A.P F 5,43,46,1,3,4,50
874,0,"K&K 2,3,4,6",2,"K&K 2,3",0,K&K 4,0,K&K 6,0,"A.P F 3,4",0,A.P F 5,3,3,0,0,0,3
875,2,"K&K 2,3,4,6",5,"K&K 2,3",15,K&K 4,0,K&K 6,12,"A.P F 3,4",0,A.P F 5,43,45,0,1,1,46
876,45,"K&K 2,3,4,6",15,"K&K 2,3",12,K&K 4,15,K&K 6,15,"A.P F 3,4",0,A.P F 5,76,121,11,4,15,136
877,36,"K&K 2,3,4,6",1,"K&K 2,3",14,K&K 4,12,K&K 6,15,"A.P F 3,4",10,A.P F 5,68,104,0,0,0,104
878,64,"K&K 2,3,4,6",10,"K&K 2,3",5,K&K 4,15,K&K 6,5,"A.P F 3,4",5,A.P F 5,47,111,5,10,15,126
879,31,"K&K 2,3,4,6",7,"K&K 2,3",15,K&K 4,8,K&K 6,5,"A.P F 3,4",5,A.P F 5,47,78,14,8,22,100
880,59,"K&K 2,3,4,6",15,"K&K 2,3",15,K&K 4,15,K&K 6,0,"A.P F 3,4",8,A.P F 5,71,130,18,19,37,167
881,32,"K&K 2,3,4,6",0,"K&K 2,3",12,K&K 4,15,K&K 6,15,"A.P F 3,4",15,A.P F 5,76,108,8,12,20,128
882,75,"K&K 2,3,4,6",15,"K&K 2,3",15,K&K 4,9,K&K 6,7,"A.P F 3,4",12,A.P F 5,68,143,15,55,70,213
883,39,"K&K 2,3,4,6",15,"K&K 2,3",0,K&K 4,15,K&K 6,4,"A.P F 3,4",2,A.P F 5,48,87,10,33,43,130
884,16,"K&K 2,3,4,6",13,"K&K 2,3",15,K&K 4,15,K&K 6,14,"A.P F 3,4",0,A.P F 5,76,92,6,26,32,124
885,56,"K&K 2,3,4,6",2,"K&K 2,3",15,K&K 4,15,K&K 6,13,"A.P F 3,4",14,A.P F 5,76,132,19,7,26,158
886,2,"K&K 2,3,4,6",4,"K&K 2,3",0,K&K 4,5,K&K 6,0,"A.P F 3,4",15,A.P F 5,32,34,5,1,6,40
887,47,"K&K 2,3,4,6",15,"K&K 2,3",15,K&K 4,10,K&K 6,15,"A.P F 3,4",15,A.P F 5,80,127,8,12,19,146
888,23,"K&K 2,3,4,6",0,"K&K 2,3",15,K&K 4,15,K&K 6,15,"A.P F 3,4",0,A.P F 5,60,83,6,15,21,104
889,39,"K&K 2,3,4,6",12,"K&K 2,3",12,K&K 4,2,K&K 6,13,"A.P F 3,4",9,A.P F 5,62,101,21,23,44,145
890,44,"K&K 2,3,4,6",12,"K&K 2,3",10,K&K 4,15,K&K 6,15,"A.P F 3,4",15,A.P F 5,76,120,22,33,55,175
891,74,"K&K 2,3,4,6",13,"K&K 2,3",6,K&K 4,0,K&K 6,7,"A.P F 3,4",12,A.P F 5,51,125,24,19,43,168
892,43,"K&K 2,3,4,6",15,"K&K 2,3",15,K&K 4,15,K&K 6,12,"A.P F 3,4",8,A.P F 5,76,119,21,11,32,151
893,29,"K&K 2,3,4,6",0,"K&K 2,3",11,K&K 4,8,K&K 6,7,"A.P F 3,4",6,A.P F 5,43,72,21,7,28,100
894,49,"K&K 2,3,4,6",0,"K&K 2,3",15,K&K 4,15,K&K 6,15,"A.P F 3,4",15,A.P F 5,80,129,8,3,11,140
895,33,"K&K 2,3,4,6",11,"K&K 2,3",15,K&K 4,11,K&K 6,14,"A.P F 3,4",2,A.P F 5,68,101,12,6,18,119
896,39,"K&K 2,3,4,6",3,"K&K 2,3",14,K&K 4,15,K&K 6,14,"A.P F 3,4",8,A.P F 5,68,107,1,3,4,111
897,38,"K&K 2,3,4,6",10,"K&K 2,3",8,K&K 4,15,K&K 6,0,"A.P F 3,4",15,A.P F 5,64,102,10,26,36,138
898,36,"K&K 2,3,4,6",15,"K&K 2,3",14,K&K 4,15,K&K 6,15,"A.P F 3,4",12,A.P F 5,79,115,15,8,23,138
899,52,"K&K 2,3,4,6",15,"K&K 2,3",15,K&K 4,15,K&K 6,15,"A.P F 3,4",0,A.P F 5,80,132,21,44,65,197
900,30,"K&K 2,3,4,6",15,"K&K 2,3",11,K&K 4,6,K&K 6,3,"A.P F 3,4",0,A.P F 5,47,77,12,8,20,97
901,47,"K&K 2,3,4,6",15,"K&K 2,3",15,K&K 4,0,K&K 6,15,"A.P F 3,4",15,A.P F 5,80,127,23,17,40,167
902,30,"K&K 2,3,4,6",0,"K&K 2,3",12,K&K 4,10,K&K 6,8,"A.P F 3,4",5,A.P F 5,47,77,6,3,9,86
903,60,"K&K 2,3,4,6",8,"K&K 2,3",15,K&K 4,10,K&K 6,5,"A.P F 3,4",0,A.P F 5,51,111,16,35,51,162
904,56,"K&K 2,3,4,6",14,"K&K 2,3",14,K&K 4,15,K&K 6,0,"A.P F 3,4",15,A.P F 5,78,134,10,55,65,199
905,44,"K&K 2,3,4,6",3,"K&K 2,3",15,K&K 4,0,K&K 6,2,"A.P F 3,4",12,A.P F 5,43,87,10,11,21,108
906,30,"K&K 2,3,4,6",0,"K&K 2,3",15,K&K 4,5,K&K 6,15,"A.P F 3,4",13,A.P F 5,64,94,4,14,18,112
907,39,"K&K 2,3,4,6",3,"K&K 2,3",11,K&K 4,4,K&K 6,9,"A.P F 3,4",11,A.P F 5,47,86,7,12,19,105
908,49,"K&K 2,3,4,6",5,"K&K 2,3",15,K&K 4,15,K&K 6,14,"A.P F 3,4",10,A.P F 5,72,121,19,18,37,158
909,48,"K&K 2,3,4,6",15,"K&K 2,3",15,K&K 4,15,K&K 6,7,"A.P F 3,4",5,A.P F 5,70,118,19,11,29,147
910,41,"K&K 2,3,4,6",12,"K&K 2,3",8,K&K 4,12,K&K 6,11,"A.P F 3,4",10,A.P F 5,60,101,19,17,36,137
911,51,"K&K 2,3,4,6",0,"K&K 2,3",15,K&K 4,12,K&K 6,7,"A.P F 3,4",9,A.P F 5,58,109,7,16,23,132
912,40,"K&K 2,3,4,6",12,"K&K 2,3",3,K&K 4,15,K&K 6,14,"A.P F 3,4",14,A.P F 5,74,114,12,25,37,151
913,31,"K&K 2,3,4,6",15,"K&K 2,3",15,K&K 4,15,K&K 6,2,"A.P F 3,4",12,A.P F 5,76,107,13,8,20,127
914,33,"K&K 2,3,4,6",15,"K&K 2,3",5,K&K 4,7,K&K 6,5,"A.P F 3,4",0,A.P F 5,43,76,14,7,21,97
915,50,"K&K 2,3,4,6",15,"K&K 2,3",14,K&K 4,15,K&K 6,15,"A.P F 3,4",0,A.P F 5,79,129,16,28,44,173
916,22,"K&K 2,3,4,6",12,"K&K 2,3",2,K&K 4,0,K&K 6,6,"A.P F 3,4",0,A.P F 5,27,49,7,4,11,60
917,41,"K&K 2,3,4,6",15,"K&K 2,3",15,K&K 4,10,K&K 6,15,"A.P F 3,4",15,A.P F 5,80,121,15,14,29,150
918,27,"K&K 2,3,4,6",7,"K&K 2,3",0,K&K 4,8,K&K 6,10,"A.P F 3,4",8,A.P F 5,44,71,18,35,53,124
919,45,"K&K 2,3,4,6",15,"K&K 2,3",15,K&K 4,8,K&K 6,14,"A.P F 3,4",15,A.P F 5,79,124,13,37,49,173
920,22,"K&K 2,3,4,6",15,"K&K 2,3",15,K&K 4,7,K&K 6,6,"A.P F 3,4",7,A.P F 5,59,81,6,8,14,95
921,34,"K&K 2,3,4,6",6,"K&K 2,3",6,K&K 4,12,K&K 6,11,"A.P F 3,4",5,A.P F 5,47,81,12,38,50,131
922,48,"K&K 2,3,4,6",15,"K&K 2,3",8,K&K 4,15,K&K 6,15,"A.P F 3,4",11,A.P F 5,75,123,24,14,38,161
923,36,"K&K 2,3,4,6",0,"K&K 2,3",15,K&K 4,15,K&K 6,15,"A.P F 3,4",10,A.P F 5,74,110,7,1,8,118
924,63,"K&K 2,3,4,6",15,"K&K 2,3",15,K&K 4,15,K&K 6,13,"A.P F 3,4",0,A.P F 5,78,141,22,31,53,194
925,39,"K&K 2,3,4,6",15,"K&K 2,3",15,K&K 4,15,K&K 6,10,"A.P F 3,4",3,A.P F 5,74,113,18,18,36,149
926,41,"K&K 2,3,4,6",12,"K&K 2,3",15,K&K 4,6,K&K 6,15,"A.P F 3,4",12,A.P F 5,72,113,29,12,41,154
927,42,"K&K 2,3,4,6",15,"K&K 2,3",15,K&K 4,15,K&K 6,2,"A.P F 3,4",15,A.P F 5,80,122,14,16,30,152
928,48,"K&K 2,3,4,6",15,"K&K 2,3",15,K&K 4,15,K&K 6,10,"A.P F 3,4",15,A.P F 5,80,128,30,42,72,200
929,33,"K&K 2,3,4,6",1,"K&K 2,3",14,K&K 4,15,K&K 6,9,"A.P F 3,4",12,A.P F 5,67,100,22,29,51,151
930,44,"K&K 2,3,4,6",14,"K&K 2,3",13,K&K 4,2,K&K 6,14,"A.P F 3,4",15,A.P F 5,75,119,7,6,13,132
931,32,"K&K 2,3,4,6",6,"K&K 2,3",11,K&K 4,15,K&K 6,15,"A.P F 3,4",7,A.P F 5,64,96,23,32,55,151
932,78,"K&K 2,3,4,6",4,"K&K 2,3",15,K&K 4,15,K&K 6,15,"A.P F 3,4",15,A.P F 5,80,158,30,10,40,198
933,35,"K&K 2,3,4,6",15,"K&K 2,3",15,K&K 4,10,K&K 6,5,"A.P F 3,4",15,A.P F 5,74,109,19,12,31,140
934,58,"K&K 2,3,4,6",15,"K&K 2,3",15,K&K 4,15,K&K 6,15,"A.P F 3,4",0,A.P F 5,80,138,26,25,51,189
935,63,"K&K 2,3,4,6",0,"K&K 2,3",0,K&K 4,12,K&K 6,12,"A.P F 3,4",13,A.P F 5,50,113,8,16,23,136
936,30,"K&K 2,3,4,6",8,"K&K 2,3",15,K&K 4,7,K&K 6,10,"A.P F 3,4",0,A.P F 5,54,84,9,9,18,102
937,59,"K&K 2,3,4,6",5,"K&K 2,3",15,K&K 4,11,K&K 6,15,"A.P F 3,4",15,A.P F 5,75,134,23,26,48,182
938,42,"K&K 2,3,4,6",4,"K&K 2,3",15,K&K 4,15,K&K 6,15,"A.P F 3,4",2,A.P F 5,66,108,12,13,25,133
939,42,"K&K 2,3,4,6",15,"K&K 2,3",15,K&K 4,15,K&K 6,15,"A.P F 3,4",0,A.P F 5,80,122,17,1,18,140
940,15,"K&K 2,3,4,6",4,"K&K 2,3",9,K&K 4,15,K&K 6,15,"A.P F 3,4",5,A.P F 5,59,74,6,10,16,90
941,74,"K&K 2,3,4,6",14,"K&K 2,3",8,K&K 4,15,K&K 6,11,"A.P F 3,4",9,A.P F 5,65,139,20,44,64,203
942,50,"K&K 2,3,4,6",5,"K&K 2,3",15,K&K 4,14,K&K 6,10,"A.P F 3,4",9,A.P F 5,64,114,10,24,34,148
943,47,"K&K 2,3,4,6",13,"K&K 2,3",15,K&K 4,9,K&K 6,13,"A.P F 3,4",15,A.P F 5,75,122,26,42,68,190
944,59,"K&K 2,3,4,6",15,"K&K 2,3",14,K&K 4,3,K&K 6,14,"A.P F 3,4",14,A.P F 5,76,135,20,31,50,185
945,12,"K&K 2,3,4,6",5,"K&K 2,3",8,K&K 4,0,K&K 6,8,"A.P F 3,4",0,A.P F 5,28,40,3,6,9,49
946,36,"K&K 2,3,4,6",15,"K&K 2,3",15,K&K 4,15,K&K 6,15,"A.P F 3,4",0,A.P F 5,80,116,21,16,37,153
947,28,"K&K 2,3,4,6",15,"K&K 2,3",15,K&K 4,15,K&K 6,14,"A.P F 3,4",0,A.P F 5,79,107,19,20,39,146
948,40,"K&K 2,3,4,6",0,"K&K 2,3",15,K&K 4,10,K&K 6,5,"A.P F 3,4",15,A.P F 5,60,100,3,5,8,108
949,45,"K&K 2,3,4,6",12,"K&K 2,3",15,K&K 4,15,K&K 6,7,"A.P F 3,4",0,A.P F 5,66,111,10,9,19,130
950,45,"K&K 2,3,4,6",10,"K&K 2,3",15,K&K 4,13,K&K 6,15,"A.P F 3,4",3,A.P F 5,71,116,3,18,21,137
951,36,"K&K 2,3,4,6",1,"K&K 2,3",15,K&K 4,13,K&K 6,3,"A.P F 3,4",15,A.P F 5,62,98,3,14,17,115
952,65,"K&K 2,3,4,6",13,"K&K 2,3",0,K&K 4,2,K&K 6,10,"A.P F 3,4",0,A.P F 5,34,99,9,21,30,129
953,7,"K&K 2,3,4,6",0,"K&K 2,3",2,K&K 4,0,K&K 6,12,"A.P F 3,4",0,A.P F 5,19,26,2,4,6,32
954,49,"K&K 2,3,4,6",2,"K&K 2,3",15,K&K 4,5,K&K 6,15,"A.P F 3,4",15,A.P F 5,67,116,3,10,13,129
955,46,"K&K 2,3,4,6",10,"K&K 2,3",15,K&K 4,15,K&K 6,4,"A.P F 3,4",15,A.P F 5,74,120,27,16,43,163
956,55,"K&K 2,3,4,6",6,"K&K 2,3",15,K&K 4,15,K&K 6,13,"A.P F 3,4",15,A.P F 5,78,133,4,4,8,141
957,71,"K&K 2,3,4,6",5,"K&K 2,3",14,K&K 4,10,K&K 6,15,"A.P F 3,4",15,A.P F 5,72,143,24,40,64,207
958,14,"K&K 2,3,4,6",15,"K&K 2,3",15,K&K 4,2,K&K 6,15,"A.P F 3,4",2,A.P F 5,63,77,9,2,11,88
959,13,"K&K 2,3,4,6",0,"K&K 2,3",0,K&K 4,15,K&K 6,13,"A.P F 3,4",3,A.P F 5,42,55,8,7,15,70
960,26,"K&K 2,3,4,6",0,"K&K 2,3",8,K&K 4,0,K&K 6,0,"A.P F 3,4",11,A.P F 5,26,52,1,5,6,58
961,10,"K&K 2,3,4,6",12,"K&K 2,3",15,K&K 4,3,K&K 6,15,"A.P F 3,4",15,A.P F 5,76,86,1,5,6,92
962,4,"K&K 2,3,4,6",15,"K&K 2,3",6,K&K 4,13,K&K 6,15,"A.P F 3,4",11,A.P F 5,72,76,9,9,18,94
963,17,"K&K 2,3,4,6",0,"K&K 2,3",0,K&K 4,0,K&K 6,8,"A.P F 3,4",15,A.P F 5,31,48,1,3,4,52
964,41,"K&K 2,3,4,6",10,"K&K 2,3",0,K&K 4,15,K&K 6,15,"A.P F 3,4",15,A.P F 5,74,115,21,42,63,178
965,38,"K&K 2,3,4,6",15,"K&K 2,3",2,K&K 4,14,K&K 6,12,"A.P F 3,4",11,A.P F 5,70,108,9,23,32,140
966,58,"K&K 2,3,4,6",15,"K&K 2,3",15,K&K 4,15,K&K 6,15,"A.P F 3,4",15,A.P F 5,80,138,25,26,51,189
967,45,"K&K 2,3,4,6",7,"K&K 2,3",15,K&K 4,2,K&K 6,15,"A.P F 3,4",12,A.P F 5,66,111,15,14,29,140
968,44,"K&K 2,3,4,6",5,"K&K 2,3",0,K&K 4,15,K&K 6,15,"A.P F 3,4",15,A.P F 5,67,111,13,12,25,136
969,36,"K&K 2,3,4,6",15,"K&K 2,3",12,K&K 4,15,K&K 6,15,"A.P F 3,4",15,A.P F 5,80,116,30,22,52,168
970,66,"K&K 2,3,4,6",15,"K&K 2,3",12,K&K 4,12,K&K 6,14,"A.P F 3,4",15,A.P F 5,75,141,19,30,49,190
971,33,"K&K 2,3,4,6",10,"K&K 2,3",15,K&K 4,0,K&K 6,15,"A.P F 3,4",15,A.P F 5,74,107,14,25,39,146
972,63,"K&K 2,3,4,6",15,"K&K 2,3",15,K&K 4,15,K&K 6,9,"A.P F 3,4",10,A.P F 5,74,137,15,5,20,157
973,54,"K&K 2,3,4,6",10,"K&K 2,3",15,K&K 4,15,K&K 6,15,"A.P F 3,4",15,A.P F 5,80,134,25,30,55,189
974,54,"K&K 2,3,4,6",15,"K&K 2,3",15,K&K 4,10,K&K 6,15,"A.P F 3,4",15,A.P F 5,80,134,10,43,53,187
975,89,"K&K 2,3,4,6",15,"K&K 2,3",7,K&K 4,15,K&K 6,15,"A.P F 3,4",15,A.P F 5,80,169,25,16,41,210
976,20,"K&K 2,3,4,6",13,"K&K 2,3",15,K&K 4,15,K&K 6,5,"A.P F 3,4",8,A.P F 5,68,88,16,10,26,114
977,26,"K&K 2,3,4,6",15,"K&K 2,3",15,K&K 4,12,K&K 6,10,"A.P F 3,4",3,A.P F 5,70,96,7,23,30,126
978,38,"K&K 2,3,4,6",15,"K&K 2,3",15,K&K 4,15,K&K 6,15,"A.P F 3,4",0,A.P F 5,80,118,11,1,12,130
979,49,"K&K 2,3,4,6",5,"K&K 2,3",11,K&K 4,15,K&K 6,15,"A.P F 3,4",9,A.P F 5,67,116,25,39,64,180
980,26,"K&K 2,3,4,6",5,"K&K 2,3",15,K&K 4,15,K&K 6,15,"A.P F 3,4",15,A.P F 5,80,106,5,1,6,112
981,46,"K&K 2,3,4,6",7,"K&K 2,3",15,K&K 4,15,K&K 6,8,"A.P F 3,4",0,A.P F 5,60,106,8,30,38,144
982,28,"K&K 2,3,4,6",15,"K&K 2,3",15,K&K 4,15,K&K 6,15,"A.P F 3,4",0,A.P F 5,80,108,22,7,29,137
983,13,"K&K 2,3,4,6",6,"K&K 2,3",13,K&K 4,15,K&K 6,4,"A.P F 3,4",3,A.P F 5,51,64,4,7,11,75
984,41,"K&K 2,3,4,6",12,"K&K 2,3",15,K&K 4,15,K&K 6,13,"A.P F 3,4",15,A.P F 5,78,119,19,14,33,152
985,36,"K&K 2,3,4,6",0,"K&K 2,3",6,K&K 4,4,K&K 6,5,"A.P F 3,4",0,A.P F 5,20,56,3,26,29,85
986,37,"K&K 2,3,4,6",2,"K&K 2,3",1,K&K 4,15,K&K 6,11,"A.P F 3,4",12,A.P F 5,54,91,7,19,26,117
987,37,"K&K 2,3,4,6",1,"K&K 2,3",15,K&K 4,5,K&K 6,15,"A.P F 3,4",15,A.P F 5,67,104,31,25,56,160
988,22,"K&K 2,3,4,6",0,"K&K 2,3",3,K&K 4,0,K&K 6,0,"A.P F 3,4",0,A.P F 5,4,26,9,0,9,35
989,30,"K&K 2,3,4,6",13,"K&K 2,3",13,K&K 4,4,K&K 6,14,"A.P F 3,4",6,A.P F 5,62,92,15,18,33,125
990,36,"K&K 2,3,4,6",7,"K&K 2,3",15,K&K 4,15,K&K 6,15,"A.P F 3,4",15,A.P F 5,80,116,23,7,30,146
991,37,"K&K 2,3,4,6",15,"K&K 2,3",12,K&K 4,6,K&K 6,7,"A.P F 3,4",8,A.P F 5,56,93,0,0,0,93
992,45,"K&K 2,3,4,6",7,"K&K 2,3",7,K&K 4,12,K&K 6,15,"A.P F 3,4",10,A.P F 5,59,104,8,11,19,123
993,38,"K&K 2,3,4,6",10,"K&K 2,3",6,K&K 4,4,K&K 6,8,"A.P F 3,4",11,A.P F 5,47,85,16,5,21,106
994,44,"K&K 2,3,4,6",12,"K&K 2,3",13,K&K 4,5,K&K 6,9,"A.P F 3,4",15,A.P F 5,66,110,10,1,11,121
995,33,"K&K 2,3,4,6",2,"K&K 2,3",15,K&K 4,2,K&K 6,15,"A.P F 3,4",15,A.P F 5,63,96,17,11,28,124
996,43,"K&K 2,3,4,6",14,"K&K 2,3",15,K&K 4,15,K&K 6,10,"A.P F 3,4",7,A.P F 5,72,115,19,28,46,161
997,32,"K&K 2,3,4,6",15,"K&K 2,3",9,K&K 4,7,K&K 6,15,"A.P F 3,4",13,A.P F 5,70,102,18,19,37,139
998,64,"K&K 2,3,4,6",14,"K&K 2,3",15,K&K 4,15,K&K 6,13,"A.P F 3,4",6,A.P F 5,76,140,18,31,49,189
999,38,"K&K 2,3,4,6",2,"K&K 2,3",15,K&K 4,2,K&K 6,15,"A.P F 3,4",8,A.P F 5,54,92,8,11,19,111
1000,34,"K&K 2,3,4,6",14,"K&K 2,3",15,K&K 4,13,K&K 6,8,"A.P F 3,4",15,A.P F 5,76,110,14,18,31,141
1001,27,"K&K 2,3,4,6",0,"K&K 2,3",7,K&K 4,3,K&K 6,0,"A.P F 3,4",0,A.P F 5,14,41,3,0,3,44
1002,38,"K&K 2,3,4,6",4,"K&K 2,3",15,K&K 4,10,K&K 6,15,"A.P F 3,4",10,A.P F 5,67,105,12,7,19,124
1003,22,"K&K 2,3,4,6",2,"K&K 2,3",10,K&K 4,15,K&K 6,15,"A.P F 3,4",14,A.P F 5,72,94,16,11,27,121
1004,62,"K&K 2,3,4,6",1,"K&K 2,3",5,K&K 4,14,K&K 6,14,"A.P F 3,4",15,A.P F 5,64,126,10,8,17,143
1005,32,"K&K 2,3,4,6",10,"K&K 2,3",15,K&K 4,10,K&K 6,6,"A.P F 3,4",10,A.P F 5,60,92,24,11,34,126
1006,22,"K&K 2,3,4,6",5,"K&K 2,3",12,K&K 4,5,K&K 6,0,"A.P F 3,4",4,A.P F 5,35,57,9,4,13,70
1007,31,"K&K 2,3,4,6",5,"K&K 2,3",13,K&K 4,15,K&K 6,14,"A.P F 3,4",14,A.P F 5,75,106,6,25,31,137
1008,45,"K&K 2,3,4,6",13,"K&K 2,3",15,K&K 4,15,K&K 6,15,"A.P F 3,4",15,A.P F 5,80,125,11,4,15,140
1009,27,"K&K 2,3,4,6",0,"K&K 2,3",2,K&K 4,2,K&K 6,15,"A.P F 3,4",10,A.P F 5,39,66,9,6,15,81
1010,3,"K&K 2,3,4,6",1,"K&K 2,3",0,K&K 4,0,K&K 6,13,"A.P F 3,4",6,A.P F 5,26,29,4,2,6,35
1011,27,"K&K 2,3,4,6",7,"K&K 2,3",15,K&K 4,8,K&K 6,15,"A.P F 3,4",13,A.P F 5,68,95,10,8,18,113
1012,40,"K&K 2,3,4,6",0,"K&K 2,3",9,K&K 4,15,K&K 6,15,"A.P F 3,4",8,A.P F 5,63,103,3,6,9,112
1013,23,"K&K 2,3,4,6",2,"K&K 2,3",15,K&K 4,15,K&K 6,0,"A.P F 3,4",8,A.P F 5,54,77,3,7,10,87
1014,20,"K&K 2,3,4,6",6,"K&K 2,3",6,K&K 4,0,K&K 6,4,"A.P F 3,4",0,A.P F 5,22,42,2,13,15,57
1015,25,"K&K 2,3,4,6",10,"K&K 2,3",9,K&K 4,0,K&K 6,6,"A.P F 3,4",15,A.P F 5,54,79,12,19,31,110
1016,36,"K&K 2,3,4,6",2,"K&K 2,3",15,K&K 4,14,K&K 6,15,"A.P F 3,4",12,A.P F 5,75,111,17,34,51,162
1017,20,"K&K 2,3,4,6",8,"K&K 2,3",7,K&K 4,5,K&K 6,7,"A.P F 3,4",0,A.P F 5,36,56,1,12,13,69
1018,42,"K&K 2,3,4,6",15,"K&K 2,3",15,K&K 4,0,K&K 6,12,"A.P F 3,4",15,A.P F 5,76,118,21,16,37,155
1019,49,"K&K 2,3,4,6",14,"K&K 2,3",11,K&K 4,7,K&K 6,8,"A.P F 3,4",11,A.P F 5,59,108,16,13,29,137
1020,29,"K&K 2,3,4,6",15,"K&K 2,3",15,K&K 4,15,K&K 6,3,"A.P F 3,4",6,A.P F 5,68,97,18,17,35,132
1021,27,"K&K 2,3,4,6",8,"K&K 2,3",12,K&K 4,13,K&K 6,0,"A.P F 3,4",15,A.P F 5,64,91,12,3,15,106
1022,33,"K&K 2,3,4,6",1,"K&K 2,3",15,K&K 4,15,K&K 6,15,"A.P F 3,4",15,A.P F 5,80,113,22,17,39,152
1023,26,"K&K 2,3,4,6",2,"K&K 2,3",15,K&K 4,15,K&K 6,5,"A.P F 3,4",8,A.P F 5,58,84,9,10,19,103
1024,44,"K&K 2,3,4,6",0,"K&K 2,3",5,K&K 4,15,K&K 6,15,"A.P F 3,4",15,A.P F 5,67,111,18,10,28,139
1025,32,"K&K 2,3,4,6",14,"K&K 2,3",15,K&K 4,15,K&K 6,15,"A.P F 3,4",15,A.P F 5,80,112,20,16,36,148
1026,51,"K&K 2,3,4,6",15,"K&K 2,3",8,K&K 4,12,K&K 6,15,"A.P F 3,4",4,A.P F 5,67,118,18,9,27,145
1027,30,"K&K 2,3,4,6",12,"K&K 2,3",10,K&K 4,5,K&K 6,15,"A.P F 3,4",6,A.P F 5,58,88,18,16,34,122
1028,32,"K&K 2,3,4,6",0,"K&K 2,3",11,K&K 4,7,K&K 6,12,"A.P F 3,4",15,A.P F 5,60,92,9,6,15,107
1029,23,"K&K 2,3,4,6",15,"K&K 2,3",14,K&K 4,15,K&K 6,11,"A.P F 3,4",6,A.P F 5,74,97,7,4,11,108
1030,17,"K&K 2,3,4,6",1,"K&K 2,3",2,K&K 4,5,K&K 6,4,"A.P F 3,4",15,A.P F 5,35,52,3,7,10,62
1031,34,"K&K 2,3,4,6",1,"K&K 2,3",6,K&K 4,0,K&K 6,4,"A.P F 3,4",12,A.P F 5,31,65,11,6,17,82
1032,5,"K&K 2,3,4,6",0,"K&K 2,3",0,K&K 4,0,K&K 6,0,"A.P F 3,4",15,A.P F 5,20,25,14,1,15,40
1033,59,"K&K 2,3,4,6",15,"K&K 2,3",14,K&K 4,15,K&K 6,15,"A.P F 3,4",0,A.P F 5,79,138,9,13,22,160
1034,37,"K&K 2,3,4,6",15,"K&K 2,3",15,K&K 4,15,K&K 6,15,"A.P F 3,4",9,A.P F 5,80,117,18,41,59,176
1035,31,"K&K 2,3,4,6",1,"K&K 2,3",11,K&K 4,12,K&K 6,15,"A.P F 3,4",15,A.P F 5,71,102,20,38,58,160
1036,32,"K&K 2,3,4,6",15,"K&K 2,3",12,K&K 4,15,K&K 6,14,"A.P F 3,4",0,A.P F 5,75,107,15,11,26,133
1037,38,"K&K 2,3,4,6",1,"K&K 2,3",11,K&K 4,7,K&K 6,15,"A.P F 3,4",15,A.P F 5,64,102,20,18,38,140
1038,33,"K&K 2,3,4,6",5,"K&K 2,3",12,K&K 4,15,K&K 6,10,"A.P F 3,4",12,A.P F 5,66,99,12,6,18,117
1039,21,"K&K 2,3,4,6",0,"K&K 2,3",12,K&K 4,15,K&K 6,15,"A.P F 3,4",15,A.P F 5,76,97,15,5,20,117
1040,53,"K&K 2,3,4,6",2,"K&K 2,3",10,K&K 4,2,K&K 6,13,"A.P F 3,4",10,A.P F 5,47,100,2,3,5,105
1041,24,"K&K 2,3,4,6",15,"K&K 2,3",8,K&K 4,4,K&K 6,0,"A.P F 3,4",0,A.P F 5,36,60,17,1,18,78
1042,32,"K&K 2,3,4,6",15,"K&K 2,3",7,K&K 4,15,K&K 6,13,"A.P F 3,4",13,A.P F 5,75,107,17,10,27,134
1043,32,"K&K 2,3,4,6",0,"K&K 2,3",5,K&K 4,4,K&K 6,9,"A.P F 3,4",7,A.P F 5,34,66,10,13,23,89
1044,0,"K&K 2,3,4,6",0,"K&K 2,3",0,K&K 4,0,K&K 6,0,"A.P F 3,4",3,A.P F 5,4,4,4,0,4,8
1045,12,"K&K 2,3,4,6",0,"K&K 2,3",15,K&K 4,15,K&K 6,5,"A.P F 3,4",0,A.P F 5,47,59,1,6,7,66
1046,3,"K&K 2,3,4,6",12,"K&K 2,3",11,K&K 4,1,K&K 6,8,"A.P F 3,4",5,A.P F 5,48,51,5,2,7,58
1047,14,"K&K 2,3,4,6",2,"K&K 2,3",5,K&K 4,1,K&K 6,4,"A.P F 3,4",4,A.P F 5,20,34,2,3,5,39
1048,3,"K&K 2,3,4,6",2,"K&K 2,3",8,K&K 4,10,K&K 6,8,"A.P F 3,4",7,A.P F 5,44,47,2,8,10,57
1049,22,"K&K 2,3,4,6",0,"K&K 2,3",2,K&K 4,0,K&K 6,10,"A.P F 3,4",0,A.P F 5,16,38,0,4,4,42
1050,0,"K&K 2,3,4,6",15,"K&K 2,3",1,K&K 4,0,K&K 6,2,"A.P F 3,4",11,A.P F 5,39,39,2,3,5,44
1051,4,"K&K 2,3,4,6",0,"K&K 2,3",0,K&K 4,1,K&K 6,2,"A.P F 3,4",3,A.P F 5,8,12,1,3,4,16
1052,28,"K&K 2,3,4,6",0,"K&K 2,3",0,K&K 4,0,K&K 6,0,"A.P F 3,4",0,A.P F 5,0,28,0,0,0,28
1053,64,"K&K 2,3,4,6",1,"K&K 2,3",12,K&K 4,15,K&K 6,15,"A.P F 3,4",15,A.P F 5,76,140,31,54,85,225
1054,47,"K&K 2,3,4,6",14,"K&K 2,3",15,K&K 4,14,K&K 6,15,"A.P F 3,4",13,A.P F 5,78,125,12,13,25,150
1055,38,"K&K 2,3,4,6",1,"K&K 2,3",12,K&K 4,15,K&K 6,14,"A.P F 3,4",12,A.P F 5,71,109,15,32,47,156
1056,44,"K&K 2,3,4,6",15,"K&K 2,3",10,K&K 4,15,K&K 6,11,"A.P F 3,4",12,A.P F 5,71,115,17,5,22,137
1057,41,"K&K 2,3,4,6",3,"K&K 2,3",15,K&K 4,15,K&K 6,9,"A.P F 3,4",10,A.P F 5,66,107,11,14,25,132
1058,56,"K&K 2,3,4,6",15,"K&K 2,3",8,K&K 4,15,K&K 6,15,"A.P F 3,4",10,A.P F 5,74,130,18,33,50,180
1059,27,"K&K 2,3,4,6",5,"K&K 2,3",5,K&K 4,4,K&K 6,10,"A.P F 3,4",0,A.P F 5,32,59,1,7,8,67
1060,30,"K&K 2,3,4,6",0,"K&K 2,3",8,K&K 4,15,K&K 6,5,"A.P F 3,4",8,A.P F 5,48,78,5,5,10,88
1061,30,"K&K 2,3,4,6",1,"K&K 2,3",5,K&K 4,0,K&K 6,15,"A.P F 3,4",14,A.P F 5,47,77,2,0,2,79
1062,46,"K&K 2,3,4,6",0,"K&K 2,3",15,K&K 4,12,K&K 6,10,"A.P F 3,4",2,A.P F 5,52,98,8,13,21,119
1063,68,"K&K 2,3,4,6",10,"K&K 2,3",15,K&K 4,15,K&K 6,15,"A.P F 3,4",0,A.P F 5,74,142,8,15,23,165
1064,39,"K&K 2,3,4,6",8,"K&K 2,3",15,K&K 4,15,K&K 6,0,"A.P F 3,4",15,A.P F 5,71,110,18,15,33,143
1065,36,"K&K 2,3,4,6",0,"K&K 2,3",15,K&K 4,15,K&K 6,0,"A.P F 3,4",15,A.P F 5,60,96,3,18,21,117
1066,42,"K&K 2,3,4,6",6,"K&K 2,3",15,K&K 4,15,K&K 6,0,"A.P F 3,4",5,A.P F 5,55,97,16,19,35,132
1067,45,"K&K 2,3,4,6",1,"K&K 2,3",13,K&K 4,3,K&K 6,12,"A.P F 3,4",15,A.P F 5,58,103,15,12,27,130
1068,50,"K&K 2,3,4,6",15,"K&K 2,3",15,K&K 4,0,K&K 6,10,"A.P F 3,4",14,A.P F 5,72,122,17,23,39,161
1069,48,"K&K 2,3,4,6",15,"K&K 2,3",4,K&K 4,0,K&K 6,15,"A.P F 3,4",15,A.P F 5,66,114,10,10,20,134
1070,59,"K&K 2,3,4,6",0,"K&K 2,3",2,K&K 4,3,K&K 6,10,"A.P F 3,4",15,A.P F 5,40,99,18,31,49,148
1071,47,"K&K 2,3,4,6",0,"K&K 2,3",15,K&K 4,6,K&K 6,8,"A.P F 3,4",15,A.P F 5,59,106,17,39,56,162
1072,38,"K&K 2,3,4,6",14,"K&K 2,3",15,K&K 4,15,K&K 6,0,"A.P F 3,4",0,A.P F 5,59,97,4,12,16,113
1073,40,"K&K 2,3,4,6",1,"K&K 2,3",15,K&K 4,15,K&K 6,15,"A.P F 3,4",15,A.P F 5,80,120,26,4,30,150
1074,38,"K&K 2,3,4,6",0,"K&K 2,3",8,K&K 4,15,K&K 6,8,"A.P F 3,4",15,A.P F 5,62,100,9,9,18,118
1075,20,"K&K 2,3,4,6",7,"K&K 2,3",15,K&K 4,15,K&K 6,12,"A.P F 3,4",15,A.P F 5,76,96,18,24,42,138
1076,35,"K&K 2,3,4,6",3,"K&K 2,3",0,K&K 4,4,K&K 6,11,"A.P F 3,4",4,A.P F 5,30,65,0,8,8,73
1077,45,"K&K 2,3,4,6",13,"K&K 2,3",6,K&K 4,11,K&K 6,15,"A.P F 3,4",10,A.P F 5,66,111,18,25,43,154
1078,43,"K&K 2,3,4,6",0,"K&K 2,3",6,K&K 4,15,K&K 6,1,"A.P F 3,4",4,A.P F 5,35,78,4,11,15,93
1079,35,"K&K 2,3,4,6",0,"K&K 2,3",13,K&K 4,7,K&K 6,6,"A.P F 3,4",12,A.P F 5,51,86,15,8,23,109
1080,31,"K&K 2,3,4,6",5,"K&K 2,3",15,K&K 4,5,K&K 6,7,"A.P F 3,4",9,A.P F 5,48,79,6,1,7,86
1081,50,"K&K 2,3,4,6",15,"K&K 2,3",0,K&K 4,15,K&K 6,13,"A.P F 3,4",12,A.P F 5,74,124,21,37,57,181
1082,36,"K&K 2,3,4,6",13,"K&K 2,3",14,K&K 4,15,K&K 6,15,"A.P F 3,4",15,A.P F 5,79,115,10,32,42,157
1083,46,"K&K 2,3,4,6",10,"K&K 2,3",8,K&K 4,7,K&K 6,12,"A.P F 3,4",15,A.P F 5,60,106,10,13,23,129
1084,42,"K&K 2,3,4,6",12,"K&K 2,3",15,K&K 4,15,K&K 6,15,"A.P F 3,4",15,A.P F 5,80,122,14,31,45,167
1085,51,"K&K 2,3,4,6",11,"K&K 2,3",15,K&K 4,15,K&K 6,15,"A.P F 3,4",0,A.P F 5,75,126,0,4,4,130
1086,46,"K&K 2,3,4,6",15,"K&K 2,3",15,K&K 4,5,K&K 6,2,"A.P F 3,4",8,A.P F 5,58,104,16,14,30,134
1087,54,"K&K 2,3,4,6",2,"K&K 2,3",15,K&K 4,12,K&K 6,1,"A.P F 3,4",15,A.P F 5,59,113,14,19,33,146
1088,48,"K&K 2,3,4,6",0,"K&K 2,3",8,K&K 4,15,K&K 6,13,"A.P F 3,4",12,A.P F 5,63,111,14,8,22,133
1089,48,"K&K 2,3,4,6",13,"K&K 2,3",14,K&K 4,7,K&K 6,11,"A.P F 3,4",0,A.P F 5,60,108,4,21,25,133
1090,65,"K&K 2,3,4,6",13,"K&K 2,3",8,K&K 4,15,K&K 6,0,"A.P F 3,4",0,A.P F 5,48,113,7,32,38,151
1091,34,"K&K 2,3,4,6",7,"K&K 2,3",15,K&K 4,14,K&K 6,7,"A.P F 3,4",3,A.P F 5,58,92,5,9,14,106
1092,36,"K&K 2,3,4,6",2,"K&K 2,3",15,K&K 4,15,K&K 6,15,"A.P F 3,4",5,A.P F 5,67,103,5,25,30,133
1093,38,"K&K 2,3,4,6",0,"K&K 2,3",0,K&K 4,2,K&K 6,11,"A.P F 3,4",0,A.P F 5,18,56,11,0,11,67
1094,35,"K&K 2,3,4,6",0,"K&K 2,3",11,K&K 4,15,K&K 6,15,"A.P F 3,4",15,A.P F 5,75,110,29,20,49,159
1095,50,"K&K 2,3,4,6",15,"K&K 2,3",15,K&K 4,15,K&K 6,15,"A.P F 3,4",14,A.P F 5,80,130,12,42,54,184
1096,53,"K&K 2,3,4,6",7,"K&K 2,3",2,K&K 4,0,K&K 6,15,"A.P F 3,4",15,A.P F 5,52,105,18,23,41,146
1097,29,"K&K 2,3,4,6",0,"K&K 2,3",3,K&K 4,8,K&K 6,10,"A.P F 3,4",15,A.P F 5,48,77,0,26,26,103
1098,39,"K&K 2,3,4,6",6,"K&K 2,3",0,K&K 4,1,K&K 6,6,"A.P F 3,4",15,A.P F 5,38,77,12,1,13,90
1099,35,"K&K 2,3,4,6",2,"K&K 2,3",8,K&K 4,15,K&K 6,2,"A.P F 3,4",4,A.P F 5,39,74,11,25,36,110
1100,53,"K&K 2,3,4,6",12,"K&K 2,3",15,K&K 4,7,K&K 6,12,"A.P F 3,4",15,A.P F 5,72,125,15,25,40,165
1101,18,"K&K 2,3,4,6",15,"K&K 2,3",0,K&K 4,15,K&K 6,15,"A.P F 3,4",15,A.P F 5,80,98,19,18,36,134
1102,30,"K&K 2,3,4,6",0,"K&K 2,3",0,K&K 4,0,K&K 6,0,"A.P F 3,4",0,A.P F 5,0,30,6,6,12,42
1103,40,"K&K 2,3,4,6",15,"K&K 2,3",15,K&K 4,15,K&K 6,14,"A.P F 3,4",0,A.P F 5,79,119,9,32,41,160
1104,40,"K&K 2,3,4,6",15,"K&K 2,3",11,K&K 4,0,K&K 6,5,"A.P F 3,4",0,A.P F 5,42,82,10,14,24,106
1105,32,"K&K 2,3,4,6",1,"K&K 2,3",1,K&K 4,0,K&K 6,15,"A.P F 3,4",15,A.P F 5,43,75,8,15,23,98
1106,51,"K&K 2,3,4,6",4,"K&K 2,3",15,K&K 4,6,K&K 6,15,"A.P F 3,4",15,A.P F 5,68,119,22,12,34,153
1107,34,"K&K 2,3,4,6",2,"K&K 2,3",10,K&K 4,15,K&K 6,15,"A.P F 3,4",4,A.P F 5,59,93,16,20,36,129
1108,22,"K&K 2,3,4,6",14,"K&K 2,3",12,K&K 4,15,K&K 6,10,"A.P F 3,4",3,A.P F 5,68,90,1,6,7,97
1109,44,"K&K 2,3,4,6",2,"K&K 2,3",10,K&K 4,15,K&K 6,15,"A.P F 3,4",15,A.P F 5,74,118,12,6,18,136
1110,14,"K&K 2,3,4,6",0,"K&K 2,3",0,K&K 4,0,K&K 6,15,"A.P F 3,4",0,A.P F 5,20,34,4,1,5,39
1111,4,"K&K 2,3,4,6",0,"K&K 2,3",0,K&K 4,0,K&K 6,0,"A.P F 3,4",10,A.P F 5,14,18,20,0,20,38
1112,0,"K&K 2,3,4,6",0,"K&K 2,3",5,K&K 4,0,K&K 6,0,"A.P F 3,4",0,A.P F 5,7,7,1,1,2,9
1113,12,"K&K 2,3,4,6",10,"K&K 2,3",6,K&K 4,4,K&K 6,7,"A.P F 3,4",0,A.P F 5,36,48,28,10,38,86
1114,27,"K&K 2,3,4,6",5,"K&K 2,3",15,K&K 4,15,K&K 6,0,"A.P F 3,4",8,A.P F 5,58,85,9,6,15,100
1115,38,"K&K 2,3,4,6",2,"K&K 2,3",8,K&K 4,0,K&K 6,12,"A.P F 3,4",14,A.P F 5,48,86,7,10,17,103
1116,39,"K&K 2,3,4,6",8,"K&K 2,3",15,K&K 4,15,K&K 6,15,"A.P F 3,4",8,A.P F 5,71,110,21,15,36,146
1117,36,"K&K 2,3,4,6",15,"K&K 2,3",15,K&K 4,15,K&K 6,0,"A.P F 3,4",2,A.P F 5,63,99,0,0,0,99
1118,25,"K&K 2,3,4,6",11,"K&K 2,3",15,K&K 4,15,K&K 6,8,"A.P F 3,4",2,A.P F 5,66,91,8,10,18,109
1119,41,"K&K 2,3,4,6",0,"K&K 2,3",15,K&K 4,15,K&K 6,15,"A.P F 3,4",15,A.P F 5,80,121,21,10,30,151
1120,42,"K&K 2,3,4,6",0,"K&K 2,3",15,K&K 4,13,K&K 6,13,"A.P F 3,4",15,A.P F 5,75,117,17,12,29,146
1121,20,"K&K 2,3,4,6",7,"K&K 2,3",8,K&K 4,15,K&K 6,15,"A.P F 3,4",15,A.P F 5,71,91,4,8,12,103
1122,46,"K&K 2,3,4,6",15,"K&K 2,3",6,K&K 4,3,K&K 6,14,"A.P F 3,4",15,A.P F 5,67,113,26,36,62,175
1123,44,"K&K 2,3,4,6",15,"K&K 2,3",15,K&K 4,15,K&K 6,13,"A.P F 3,4",15,A.P F 5,80,124,30,36,66,190
1124,37,"K&K 2,3,4,6",1,"K&K 2,3",8,K&K 4,0,K&K 6,2,"A.P F 3,4",8,A.P F 5,26,63,3,10,13,76
1125,39,"K&K 2,3,4,6",15,"K&K 2,3",8,K&K 4,3,K&K 6,13,"A.P F 3,4",10,A.P F 5,62,101,31,15,46,147
1126,28,"K&K 2,3,4,6",0,"K&K 2,3",14,K&K 4,0,K&K 6,12,"A.P F 3,4",0,A.P F 5,35,63,6,16,22,85
1127,35,"K&K 2,3,4,6",0,"K&K 2,3",12,K&K 4,15,K&K 6,15,"A.P F 3,4",5,A.P F 5,63,98,3,11,14,112
1128,50,"K&K 2,3,4,6",12,"K&K 2,3",15,K&K 4,15,K&K 6,15,"A.P F 3,4",15,A.P F 5,80,130,23,21,44,174
1129,15,"K&K 2,3,4,6",10,"K&K 2,3",15,K&K 4,12,K&K 6,1,"A.P F 3,4",13,A.P F 5,67,82,2,1,3,85
1130,58,"K&K 2,3,4,6",13,"K&K 2,3",13,K&K 4,2,K&K 6,8,"A.P F 3,4",2,A.P F 5,48,106,11,8,19,125
1131,39,"K&K 2,3,4,6",8,"K&K 2,3",7,K&K 4,10,K&K 6,15,"A.P F 3,4",11,A.P F 5,59,98,5,8,13,111
1132,25,"K&K 2,3,4,6",15,"K&K 2,3",15,K&K 4,3,K&K 6,15,"A.P F 3,4",2,A.P F 5,64,89,2,3,5,94
1133,6,"K&K 2,3,4,6",0,"K&K 2,3",11,K&K 4,0,K&K 6,5,"A.P F 3,4",15,A.P F 5,42,48,1,4,5,53
1134,2,"K&K 2,3,4,6",0,"K&K 2,3",3,K&K 4,0,K&K 6,0,"A.P F 3,4",0,A.P F 5,4,6,0,6,6,12
1135,2,"K&K 2,3,4,6",0,"K&K 2,3",11,K&K 4,3,K&K 6,5,"A.P F 3,4",15,A.P F 5,46,48,0,6,6,54
1136,12,"K&K 2,3,4,6",15,"K&K 2,3",15,K&K 4,15,K&K 6,5,"A.P F 3,4",4,A.P F 5,67,79,0,5,5,84
1137,4,"K&K 2,3,4,6",8,"K&K 2,3",8,K&K 4,2,K&K 6,2,"A.P F 3,4",0,A.P F 5,27,31,0,3,3,34
1138,4,"K&K 2,3,4,6",1,"K&K 2,3",0,K&K 4,9,K&K 6,2,"A.P F 3,4",11,A.P F 5,31,35,9,2,11,46
1139,6,"K&K 2,3,4,6",1,"K&K 2,3",1,K&K 4,15,K&K 6,3,"A.P F 3,4",10,A.P F 5,39,45,15,9,24,69
1140,6,"K&K 2,3,4,6",7,"K&K 2,3",13,K&K 4,0,K&K 6,0,"A.P F 3,4",0,A.P F 5,27,33,14,9,23,56
1141,7,"K&K 2,3,4,6",9,"K&K 2,3",15,K&K 4,0,K&K 6,0,"A.P F 3,4",0,A.P F 5,32,39,0,0,0,39
1142,2,"K&K 2,3,4,6",2,"K&K 2,3",5,K&K 4,3,K&K 6,7,"A.P F 3,4",5,A.P F 5,27,29,8,5,13,42
1143,7,"K&K 2,3,4,6",0,"K&K 2,3",0,K&K 4,5,K&K 6,0,"A.P F 3,4",4,A.P F 5,12,19,7,1,8,27
1144,7,"K&K 2,3,4,6",0,"K&K 2,3",0,K&K 4,0,K&K 6,2,"A.P F 3,4",0,A.P F 5,3,10,0,7,7,17
1145,21,"K&K 2,3,4,6",2,"K&K 2,3",11,K&K 4,0,K&K 6,5,"A.P F 3,4",7,A.P F 5,34,55,5,1,6,61
1146,2,"K&K 2,3,4,6",0,"K&K 2,3",0,K&K 4,0,K&K 6,7,"A.P F 3,4",15,A.P F 5,30,32,0,4,4,36
1147,0,"K&K 2,3,4,6",5,"K&K 2,3",13,K&K 4,0,K&K 6,0,"A.P F 3,4",0,A.P F 5,24,24,7,6,13,37
1148,2,"K&K 2,3,4,6",0,"K&K 2,3",5,K&K 4,2,K&K 6,2,"A.P F 3,4",0,A.P F 5,12,14,0,1,1,15
1149,0,"K&K 2,3,4,6",1,"K&K 2,3",1,K&K 4,0,K&K 6,0,"A.P F 3,4",0,A.P F 5,3,3,0,6,6,9
1150,2,"K&K 2,3,4,6",0,"K&K 2,3",0,K&K 4,2,K&K 6,0,"A.P F 3,4",0,A.P F 5,3,5,3,3,6,11
1151,2,"K&K 2,3,4,6",15,"K&K 2,3",3,K&K 4,0,K&K 6,10,"A.P F 3,4",2,A.P F 5,40,42,3,0,3,45
1152,7,"K&K 2,3,4,6",1,"K&K 2,3",1,K&K 4,1,K&K 6,7,"A.P F 3,4",15,A.P F 5,32,39,7,0,7,46
1153,41,"K&K 2,3,4,6",14,"K&K 2,3",8,K&K 4,14,K&K 6,11,"A.P F 3,4",14,A.P F 5,71,112,18,27,45,157
1154,6,"K&K 2,3,4,6",2,"K&K 2,3",1,K&K 4,5,K&K 6,8,"A.P F 3,4",6,A.P F 5,28,34,9,5,14,48
1155,27,"K&K 2,3,4,6",9,"K&K 2,3",10,K&K 4,11,K&K 6,12,"A.P F 3,4",14,A.P F 5,62,89,9,29,38,127
1156,1,"K&K 2,3,4,6",2,"K&K 2,3",3,K&K 4,5,K&K 6,0,"A.P F 3,4",1,A.P F 5,14,15,2,3,5,20
1157,11,"K&K 2,3,4,6",8,"K&K 2,3",5,K&K 4,9,K&K 6,8,"A.P F 3,4",2,A.P F 5,39,50,15,4,19,69
1158,45,"K&K 2,3,4,6",7,"K&K 2,3",8,K&K 4,6,K&K 6,11,"A.P F 3,4",1,A.P F 5,41,86,14,18,32,118
1159,9,"K&K 2,3,4,6",11,"K&K 2,3",8,K&K 4,12,K&K 6,11,"A.P F 3,4",0,A.P F 5,55,64,26,21,47,111
1160,31,"K&K 2,3,4,6",10,"K&K 2,3",12,K&K 4,13,K&K 6,15,"A.P F 3,4",6,A.P F 5,66,97,13,6,19,116
1161,13,"K&K 2,3,4,6",8,"K&K 2,3",6,K&K 4,0,K&K 6,0,"A.P F 3,4",0,A.P F 5,18,31,6,6,12,43
1162,5,"K&K 2,3,4,6",8,"K&K 2,3",6,K&K 4,4,K&K 6,0,"A.P F 3,4",0,A.P F 5,24,29,0,9,9,38
1163,29,"K&K 2,3,4,6",9,"K&K 2,3",11,K&K 4,11,K&K 6,15,"A.P F 3,4",9,A.P F 5,62,91,18,34,52,143
1164,35,"K&K 2,3,4,6",10,"K&K 2,3",9,K&K 4,3,K&K 6,9,"A.P F 3,4",10,A.P F 5,50,85,15,16,31,116
1165,15,"K&K 2,3,4,6",5,"K&K 2,3",9,K&K 4,11,K&K 6,0,"A.P F 3,4",2,A.P F 5,35,50,8,11,19,69
1166,57,"K&K 2,3,4,6",13,"K&K 2,3",9,K&K 4,13,K&K 6,1,"A.P F 3,4",4,A.P F 5,51,108,28,17,45,153
1167,60,"K&K 2,3,4,6",14,"K&K 2,3",8,K&K 4,15,K&K 6,9,"A.P F 3,4",6,A.P F 5,61,121,23,33,56,177
1168,21,"K&K 2,3,4,6",8,"K&K 2,3",8,K&K 4,15,K&K 6,7,"A.P F 3,4",10,A.P F 5,55,76,25,9,34,110
1169,0,"K&K 2,3,4,6",0,"K&K 2,3",0,K&K 4,0,K&K 6,0,"A.P F 3,4",0,A.P F 5,0,0,0,0,0,0
1170,27,"K&K 2,3,4,6",14,"K&K 2,3",9,K&K 4,13,K&K 6,8,"A.P F 3,4",12,A.P F 5,63,90,33,25,58,148
1171,23,"K&K 2,3,4,6",0,"K&K 2,3",8,K&K 4,14,K&K 6,7,"A.P F 3,4",10,A.P F 5,52,75,26,13,39,114
1172,20,"K&K 2,3,4,6",7,"K&K 2,3",8,K&K 4,15,K&K 6,14,"A.P F 3,4",7,A.P F 5,58,78,16,18,34,112
1173,13,"K&K 2,3,4,6",8,"K&K 2,3",2,K&K 4,5,K&K 6,2,"A.P F 3,4",2,A.P F 5,24,37,12,9,21,58
1174,10,"K&K 2,3,4,6",0,"K&K 2,3",0,K&K 4,0,K&K 6,5,"A.P F 3,4",3,A.P F 5,10,20,13,2,15,35
1175,12,"K&K 2,3,4,6",12,"K&K 2,3",9,K&K 4,15,K&K 6,15,"A.P F 3,4",0,A.P F 5,68,80,18,13,31,111
1176,14,"K&K 2,3,4,6",9,"K&K 2,3",10,K&K 4,9,K&K 6,12,"A.P F 3,4",5,A.P F 5,53,67,15,20,35,102
1177,38,"K&K 2,3,4,6",0,"K&K 2,3",4,K&K 4,0,K&K 6,11,"A.P F 3,4",1,A.P F 5,21,59,4,6,10,69
1178,6,"K&K 2,3,4,6",7,"K&K 2,3",3,K&K 4,5,K&K 6,8,"A.P F 3,4",10,A.P F 5,40,46,19,22,41,87
1179,17,"K&K 2,3,4,6",8,"K&K 2,3",15,K&K 4,12,K&K 6,13,"A.P F 3,4",7,A.P F 5,64,81,32,22,54,135
1180,20,"K&K 2,3,4,6",9,"K&K 2,3",14,K&K 4,11,K&K 6,14,"A.P F 3,4",1,A.P F 5,64,84,13,9,22,106
1181,3,"K&K 2,3,4,6",2,"K&K 2,3",2,K&K 4,6,K&K 6,4,"A.P F 3,4",2,A.P F 5,19,22,10,6,16,38
1182,4,"K&K 2,3,4,6",7,"K&K 2,3",4,K&K 4,13,K&K 6,8,"A.P F 3,4",15,A.P F 5,56,60,9,14,23,83
1183,38,"K&K 2,3,4,6",9,"K&K 2,3",10,K&K 4,5,K&K 6,15,"A.P F 3,4",4,A.P F 5,51,89,26,22,48,137
1184,35,"K&K 2,3,4,6",13,"K&K 2,3",11,K&K 4,15,K&K 6,13,"A.P F 3,4",14,A.P F 5,74,109,33,18,51,160
1185,24,"K&K 2,3,4,6",11,"K&K 2,3",13,K&K 4,5,K&K 6,9,"A.P F 3,4",5,A.P F 5,51,75,19,20,39,114
1186,32,"K&K 2,3,4,6",15,"K&K 2,3",5,K&K 4,6,K&K 6,14,"A.P F 3,4",8,A.P F 5,58,90,12,19,31,121
1187,1,"K&K 2,3,4,6",1,"K&K 2,3",1,K&K 4,2,K&K 6,2,"A.P F 3,4",2,A.P F 5,8,9,0,3,3,12
1188,11,"K&K 2,3,4,6",11,"K&K 2,3",8,K&K 4,5,K&K 6,8,"A.P F 3,4",14,A.P F 5,52,63,24,17,41,104
1189,11,"K&K 2,3,4,6",12,"K&K 2,3",11,K&K 4,15,K&K 6,11,"A.P F 3,4",0,A.P F 5,64,75,3,3,6,81
1190,30,"K&K 2,3,4,6",6,"K&K 2,3",8,K&K 4,15,K&K 6,14,"A.P F 3,4",5,A.P F 5,58,88,12,7,19,107
1191,11,"K&K 2,3,4,6",10,"K&K 2,3",8,K&K 4,11,K&K 6,0,"A.P F 3,4",8,A.P F 5,48,59,7,10,17,76
1192,0,"K&K 2,3,4,6",6,"K&K 2,3",0,K&K 4,11,K&K 6,1,"A.P F 3,4",1,A.P F 5,25,25,3,2,5,30
1193,25,"K&K 2,3,4,6",11,"K&K 2,3",12,K&K 4,14,K&K 6,15,"A.P F 3,4",6,A.P F 5,69,94,27,30,57,151
1194,25,"K&K 2,3,4,6",10,"K&K 2,3",13,K&K 4,10,K&K 6,9,"A.P F 3,4",7,A.P F 5,55,80,19,9,28,108
1195,5,"K&K 2,3,4,6",0,"K&K 2,3",0,K&K 4,0,K&K 6,0,"A.P F 3,4",2,A.P F 5,3,8,6,4,10,18
1196,14,"K&K 2,3,4,6",8,"K&K 2,3",6,K&K 4,6,K&K 6,6,"A.P F 3,4",1,A.P F 5,34,48,18,11,29,77
1197,13,"K&K 2,3,4,6",9,"K&K 2,3",5,K&K 4,1,K&K 6,2,"A.P F 3,4",0,A.P F 5,23,36,15,10,25,61
1198,8,"K&K 2,3,4,6",5,"K&K 2,3",12,K&K 4,11,K&K 6,8,"A.P F 3,4",2,A.P F 5,46,54,9,5,14,68
1199,12,"K&K 2,3,4,6",11,"K&K 2,3",12,K&K 4,8,K&K 6,12,"A.P F 3,4",6,A.P F 5,56,68,30,31,61,129
1200,3,"K&K 2,3,4,6",6,"K&K 2,3",11,K&K 4,11,K&K 6,13,"A.P F 3,4",8,A.P F 5,56,59,18,14,32,91
1201,6,"K&K 2,3,4,6",4,"K&K 2,3",8,K&K 4,0,K&K 6,12,"A.P F 3,4",0,A.P F 5,32,38,12,14,26,64
1202,7,"K&K 2,3,4,6",10,"K&K 2,3",11,K&K 4,10,K&K 6,15,"A.P F 3,4",14,A.P F 5,67,74,35,19,54,128
1203,15,"K&K 2,3,4,6",4,"K&K 2,3",9,K&K 4,5,K&K 6,2,"A.P F 3,4",13,A.P F 5,41,56,17,9,26,82
1204,34,"K&K 2,3,4,6",7,"K&K 2,3",11,K&K 4,15,K&K 6,2,"A.P F 3,4",5,A.P F 5,51,84,24,20,44,128
1205,4,"K&K 2,3,4,6",0,"K&K 2,3",7,K&K 4,0,K&K 6,0,"A.P F 3,4",0,A.P F 5,9,13,9,3,12,25
1206,52,"K&K 2,3,4,6",10,"K&K 2,3",14,K&K 4,10,K&K 6,15,"A.P F 3,4",5,A.P F 5,64,116,23,18,41,157
1207,51,"K&K 2,3,4,6",10,"K&K 2,3",12,K&K 4,11,K&K 6,15,"A.P F 3,4",7,A.P F 5,63,114,24,11,35,149
1208,5,"K&K 2,3,4,6",8,"K&K 2,3",9,K&K 4,9,K&K 6,0,"A.P F 3,4",2,A.P F 5,37,42,4,2,6,48
1209,18,"K&K 2,3,4,6",11,"K&K 2,3",7,K&K 4,3,K&K 6,14,"A.P F 3,4",3,A.P F 5,45,63,18,20,38,101
1210,12,"K&K 2,3,4,6",11,"K&K 2,3",8,K&K 4,13,K&K 6,8,"A.P F 3,4",9,A.P F 5,55,67,19,8,27,94
1211,26,"K&K 2,3,4,6",8,"K&K 2,3",6,K&K 4,2,K&K 6,13,"A.P F 3,4",4,A.P F 5,41,67,26,16,42,109
1212,6,"K&K 2,3,4,6",5,"K&K 2,3",4,K&K 4,2,K&K 6,0,"A.P F 3,4",4,A.P F 5,19,25,6,7,13,38
1213,2,"K&K 2,3,4,6",4,"K&K 2,3",0,K&K 4,2,K&K 6,2,"A.P F 3,4",0,A.P F 5,10,12,0,2,2,14
1214,8,"K&K 2,3,4,6",8,"K&K 2,3",4,K&K 4,2,K&K 6,12,"A.P F 3,4",9,A.P F 5,43,51,21,19,40,91
1215,10,"K&K 2,3,4,6",6,"K&K 2,3",2,K&K 4,2,K&K 6,5,"A.P F 3,4",1,A.P F 5,18,28,11,16,27,55
1216,12,"K&K 2,3,4,6",8,"K&K 2,3",8,K&K 4,11,K&K 6,15,"A.P F 3,4",9,A.P F 5,58,70,13,25,38,108
1217,21,"K&K 2,3,4,6",11,"K&K 2,3",13,K&K 4,8,K&K 6,12,"A.P F 3,4",5,A.P F 5,59,80,15,21,36,116
1218,8,"K&K 2,3,4,6",10,"K&K 2,3",2,K&K 4,13,K&K 6,8,"A.P F 3,4",10,A.P F 5,53,61,11,14,25,86
1219,0,"K&K 2,3,4,6",0,"K&K 2,3",0,K&K 4,8,K&K 6,5,"A.P F 3,4",5,A.P F 5,23,23,3,1,4,27
1220,22,"K&K 2,3,4,6",14,"K&K 2,3",12,K&K 4,11,K&K 6,14,"A.P F 3,4",15,A.P F 5,73,95,18,25,43,138
1221,5,"K&K 2,3,4,6",0,"K&K 2,3",0,K&K 4,0,K&K 6,2,"A.P F 3,4",0,A.P F 5,3,8,0,2,2,10
1222,16,"K&K 2,3,4,6",11,"K&K 2,3",9,K&K 4,7,K&K 6,15,"A.P F 3,4",8,A.P F 5,57,73,21,25,46,119
1223,0,"K&K 2,3,4,6",0,"K&K 2,3",0,K&K 4,0,K&K 6,0,"A.P F 3,4",0,A.P F 5,0,0,6,3,9,9
1224,35,"K&K 2,3,4,6",5,"K&K 2,3",11,K&K 4,8,K&K 6,10,"A.P F 3,4",2,A.P F 5,45,80,21,14,35,115
1225,7,"K&K 2,3,4,6",2,"K&K 2,3",8,K&K 4,1,K&K 6,0,"A.P F 3,4",2,A.P F 5,15,22,3,12,15,37
1226,50,"K&K 2,3,4,6",11,"K&K 2,3",11,K&K 4,15,K&K 6,9,"A.P F 3,4",6,A.P F 5,61,111,15,14,29,140
1227,11,"K&K 2,3,4,6",4,"K&K 2,3",4,K&K 4,1,K&K 6,10,"A.P F 3,4",10,A.P F 5,36,47,24,19,43,90
1228,12,"K&K 2,3,4,6",8,"K&K 2,3",8,K&K 4,11,K&K 6,6,"A.P F 3,4",3,A.P F 5,43,55,17,12,29,84
1229,24,"K&K 2,3,4,6",7,"K&K 2,3",9,K&K 4,15,K&K 6,4,"A.P F 3,4",1,A.P F 5,46,70,14,15,29,99
1230,25,"K&K 2,3,4,6",11,"K&K 2,3",12,K&K 4,15,K&K 6,8,"A.P F 3,4",0,A.P F 5,62,87,9,18,27,114
1231,15,"K&K 2,3,4,6",11,"K&K 2,3",12,K&K 4,15,K&K 6,15,"A.P F 3,4",9,A.P F 5,71,86,30,28,58,144
1232,6,"K&K 2,3,4,6",12,"K&K 2,3",11,K&K 4,11,K&K 6,3,"A.P F 3,4",0,A.P F 5,49,55,22,14,36,91
1233,20,"K&K 2,3,4,6",14,"K&K 2,3",10,K&K 4,13,K&K 6,15,"A.P F 3,4",15,A.P F 5,76,96,28,24,52,148
1234,69,"K&K 2,3,4,6",8,"K&K 2,3",14,K&K 4,14,K&K 6,15,"A.P F 3,4",10,A.P F 5,69,138,29,30,59,197
1235,7,"K&K 2,3,4,6",11,"K&K 2,3",0,K&K 4,11,K&K 6,14,"A.P F 3,4",2,A.P F 5,49,56,18,25,43,99
1236,7,"K&K 2,3,4,6",9,"K&K 2,3",6,K&K 4,11,K&K 6,14,"A.P F 3,4",7,A.P F 5,54,61,27,12,39,100
1237,30,"K&K 2,3,4,6",3,"K&K 2,3",11,K&K 4,15,K&K 6,8,"A.P F 3,4",2,A.P F 5,49,79,27,9,36,115
1238,34,"K&K 2,3,4,6",10,"K&K 2,3",8,K&K 4,14,K&K 6,15,"A.P F 3,4",10,A.P F 5,65,99,6,35,41,140
1239,19,"K&K 2,3,4,6",7,"K&K 2,3",11,K&K 4,15,K&K 6,15,"A.P F 3,4",15,A.P F 5,75,94,15,21,36,130
1240,20,"K&K 2,3,4,6",11,"K&K 2,3",6,K&K 4,13,K&K 6,9,"A.P F 3,4",15,A.P F 5,64,84,24,23,47,131
1241,11,"K&K 2,3,4,6",1,"K&K 2,3",12,K&K 4,12,K&K 6,14,"A.P F 3,4",9,A.P F 5,63,74,13,8,21,95
1242,9,"K&K 2,3,4,6",9,"K&K 2,3",6,K&K 4,0,K&K 6,2,"A.P F 3,4",1,A.P F 5,23,32,11,0,11,43
1243,7,"K&K 2,3,4,6",5,"K&K 2,3",6,K&K 4,8,K&K 6,5,"A.P F 3,4",13,A.P F 5,43,50,11,17,28,78
1244,10,"K&K 2,3,4,6",6,"K&K 2,3",9,K&K 4,11,K&K 6,6,"A.P F 3,4",14,A.P F 5,52,62,23,10,33,95
1245,37,"K&K 2,3,4,6",14,"K&K 2,3",14,K&K 4,15,K&K 6,14,"A.P F 3,4",3,A.P F 5,74,111,30,24,54,165
1246,10,"K&K 2,3,4,6",9,"K&K 2,3",4,K&K 4,4,K&K 6,2,"A.P F 3,4",0,A.P F 5,25,35,14,13,27,62
1247,5,"K&K 2,3,4,6",2,"K&K 2,3",0,K&K 4,8,K&K 6,2,"A.P F 3,4",0,A.P F 5,15,20,6,13,19,39
1248,30,"K&K 2,3,4,6",12,"K&K 2,3",12,K&K 4,15,K&K 6,8,"A.P F 3,4",8,A.P F 5,63,93,29,20,49,142
1249,11,"K&K 2,3,4,6",5,"K&K 2,3",6,K&K 4,15,K&K 6,11,"A.P F 3,4",2,A.P F 5,49,60,11,10,21,81
1250,23,"K&K 2,3,4,6",14,"K&K 2,3",11,K&K 4,5,K&K 6,13,"A.P F 3,4",6,A.P F 5,58,81,12,11,23,104
1251,7,"K&K 2,3,4,6",6,"K&K 2,3",12,K&K 4,9,K&K 6,11,"A.P F 3,4",2,A.P F 5,51,57,23,18,41,98
1252,13,"K&K 2,3,4,6",4,"K&K 2,3",10,K&K 4,12,K&K 6,13,"A.P F 3,4",8,A.P F 5,57,70,19,19,38,108
1253,20,"K&K 2,3,4,6",3,"K&K 2,3",9,K&K 4,15,K&K 6,4,"A.P F 3,4",0,A.P F 5,42,62,13,11,24,86
1254,10,"K&K 2,3,4,6",8,"K&K 2,3",8,K&K 4,14,K&K 6,0,"A.P F 3,4",2,A.P F 5,41,51,11,17,28,79
1255,26,"K&K 2,3,4,6",6,"K&K 2,3",8,K&K 4,11,K&K 6,8,"A.P F 3,4",8,A.P F 5,45,71,18,16,34,105
1256,21,"K&K 2,3,4,6",12,"K&K 2,3",13,K&K 4,15,K&K 6,0,"A.P F 3,4",12,A.P F 5,69,90,22,27,49,139
1257,17,"K&K 2,3,4,6",0,"K&K 2,3",0,K&K 4,7,K&K 6,12,"A.P F 3,4",9,A.P F 5,37,54,19,7,26,80
1258,9,"K&K 2,3,4,6",6,"K&K 2,3",11,K&K 4,3,K&K 6,8,"A.P F 3,4",14,A.P F 5,50,59,17,3,20,79
1259,4,"K&K 2,3,4,6",5,"K&K 2,3",8,K&K 4,0,K&K 6,5,"A.P F 3,4",3,A.P F 5,28,32,3,4,7,39
1260,8,"K&K 2,3,4,6",5,"K&K 2,3",5,K&K 4,0,K&K 6,3,"A.P F 3,4",7,A.P F 5,26,34,17,10,27,61
1261,27,"K&K 2,3,4,6",8,"K&K 2,3",12,K&K 4,6,K&K 6,13,"A.P F 3,4",3,A.P F 5,52,79,14,12,26,105
1262,5,"K&K 2,3,4,6",7,"K&K 2,3",11,K&K 4,4,K&K 6,2,"A.P F 3,4",3,A.P F 5,32,37,5,4,9,46
1263,37,"K&K 2,3,4,6",12,"K&K 2,3",10,K&K 4,15,K&K 6,13,"A.P F 3,4",5,A.P F 5,67,104,18,33,51,155
1264,23,"K&K 2,3,4,6",6,"K&K 2,3",8,K&K 4,12,K&K 6,7,"A.P F 3,4",0,A.P F 5,44,67,23,15,38,105
1265,11,"K&K 2,3,4,6",7,"K&K 2,3",3,K&K 4,9,K&K 6,4,"A.P F 3,4",0,A.P F 5,30,41,1,3,4,45
1266,13,"K&K 2,3,4,6",11,"K&K 2,3",9,K&K 4,14,K&K 6,9,"A.P F 3,4",5,A.P F 5,57,70,19,22,41,111
1267,16,"K&K 2,3,4,6",2,"K&K 2,3",7,K&K 4,8,K&K 6,11,"A.P F 3,4",3,A.P F 5,38,54,15,10,25,79
1268,17,"K&K 2,3,4,6",11,"K&K 2,3",8,K&K 4,10,K&K 6,14,"A.P F 3,4",3,A.P F 5,55,72,11,19,30,102
1269,10,"K&K 2,3,4,6",8,"K&K 2,3",11,K&K 4,14,K&K 6,11,"A.P F 3,4",0,A.P F 5,57,67,7,12,19,86
1270,14,"K&K 2,3,4,6",12,"K&K 2,3",11,K&K 4,5,K&K 6,15,"A.P F 3,4",13,A.P F 5,68,82,22,22,44,126
1271,37,"K&K 2,3,4,6",5,"K&K 2,3",12,K&K 4,7,K&K 6,15,"A.P F 3,4",15,A.P F 5,65,102,30,23,53,155
1272,21,"K&K 2,3,4,6",12,"K&K 2,3",8,K&K 4,15,K&K 6,7,"A.P F 3,4",0,A.P F 5,56,77,18,28,46,123
1273,42,"K&K 2,3,4,6",10,"K&K 2,3",8,K&K 4,14,K&K 6,15,"A.P F 3,4",11,A.P F 5,66,108,24,33,57,165
1274,11,"K&K 2,3,4,6",8,"K&K 2,3",12,K&K 4,11,K&K 6,15,"A.P F 3,4",11,A.P F 5,64,75,11,14,25,100
1275,35,"K&K 2,3,4,6",11,"K&K 2,3",10,K&K 4,9,K&K 6,15,"A.P F 3,4",13,A.P F 5,65,100,30,30,60,160
1276,37,"K&K 2,3,4,6",5,"K&K 2,3",10,K&K 4,12,K&K 6,4,"A.P F 3,4",2,A.P F 5,41,78,15,14,29,107
1277,35,"K&K 2,3,4,6",15,"K&K 2,3",15,K&K 4,11,K&K 6,15,"A.P F 3,4",13,A.P F 5,77,112,18,23,41,153
1278,8,"K&K 2,3,4,6",5,"K&K 2,3",8,K&K 4,14,K&K 6,7,"A.P F 3,4",8,A.P F 5,48,56,6,5,11,67
1279,32,"K&K 2,3,4,6",12,"K&K 2,3",13,K&K 4,11,K&K 6,15,"A.P F 3,4",1,A.P F 5,67,99,19,16,35,134
1280,30,"K&K 2,3,4,6",14,"K&K 2,3",11,K&K 4,14,K&K 6,15,"A.P F 3,4",14,A.P F 5,77,107,29,20,49,156
1281,24,"K&K 2,3,4,6",4,"K&K 2,3",11,K&K 4,15,K&K 6,8,"A.P F 3,4",12,A.P F 5,62,86,27,18,45,131
1282,41,"K&K 2,3,4,6",11,"K&K 2,3",9,K&K 4,11,K&K 6,15,"A.P F 3,4",6,A.P F 5,61,102,25,27,52,154
1283,18,"K&K 2,3,4,6",14,"K&K 2,3",12,K&K 4,7,K&K 6,15,"A.P F 3,4",11,A.P F 5,68,86,19,16,35,121
1284,5,"K&K 2,3,4,6",10,"K&K 2,3",2,K&K 4,5,K&K 6,2,"A.P F 3,4",0,A.P F 5,25,30,10,4,14,44
1285,27,"K&K 2,3,4,6",6,"K&K 2,3",13,K&K 4,12,K&K 6,12,"A.P F 3,4",0,A.P F 5,57,84,19,17,36,120
1286,14,"K&K 2,3,4,6",13,"K&K 2,3",6,K&K 4,6,K&K 6,5,"A.P F 3,4",6,A.P F 5,41,55,21,24,45,100
1287,30,"K&K 2,3,4,6",2,"K&K 2,3",0,K&K 4,11,K&K 6,5,"A.P F 3,4",0,A.P F 5,23,53,14,9,23,76
1288,8,"K&K 2,3,4,6",5,"K&K 2,3",7,K&K 4,14,K&K 6,8,"A.P F 3,4",6,A.P F 5,46,54,6,17,23,77
1289,8,"K&K 2,3,4,6",5,"K&K 2,3",8,K&K 4,5,K&K 6,6,"A.P F 3,4",2,A.P F 5,31,39,1,14,15,54
1290,55,"K&K 2,3,4,6",13,"K&K 2,3",12,K&K 4,15,K&K 6,11,"A.P F 3,4",9,A.P F 5,68,123,40,22,62,185
1291,5,"K&K 2,3,4,6",8,"K&K 2,3",8,K&K 4,4,K&K 6,9,"A.P F 3,4",11,A.P F 5,46,51,10,17,27,78
1292,19,"K&K 2,3,4,6",12,"K&K 2,3",11,K&K 4,12,K&K 6,15,"A.P F 3,4",10,A.P F 5,67,86,27,15,42,128
1293,6,"K&K 2,3,4,6",0,"K&K 2,3",3,K&K 4,4,K&K 6,6,"A.P F 3,4",2,A.P F 5,20,26,11,2,13,39
1294,13,"K&K 2,3,4,6",11,"K&K 2,3",11,K&K 4,8,K&K 6,11,"A.P F 3,4",8,A.P F 5,54,67,13,4,17,84
1295,21,"K&K 2,3,4,6",8,"K&K 2,3",11,K&K 4,0,K&K 6,14,"A.P F 3,4",5,A.P F 5,49,70,,,0,70
1296,20,"K&K 2,3,4,6",8,"K&K 2,3",12,K&K 4,11,K&K 6,14,"A.P F 3,4",10,A.P F 5,62,82,26,29,55,137
1297,33,"K&K 2,3,4,6",10,"K&K 2,3",11,K&K 4,8,K&K 6,15,"A.P F 3,4",8,A.P F 5,59,92,20,21,41,133
1298,1,"K&K 2,3,4,6",2,"K&K 2,3",0,K&K 4,1,K&K 6,2,"A.P F 3,4",2,A.P F 5,7,8,0,2,2,10
1299,25,"K&K 2,3,4,6",8,"K&K 2,3",10,K&K 4,9,K&K 6,0,"A.P F 3,4",9,A.P F 5,48,73,10,16,26,99
1300,4,"K&K 2,3,4,6",5,"K&K 2,3",0,K&K 4,1,K&K 6,6,"A.P F 3,4",2,A.P F 5,18,22,0,4,4,26
1301,10,"K&K 2,3,4,6",2,"K&K 2,3",0,K&K 4,12,K&K 6,8,"A.P F 3,4",2,A.P F 5,30,40,3,5,8,48
1302,7,"K&K 2,3,4,6",2,"K&K 2,3",2,K&K 4,8,K&K 6,5,"A.P F 3,4",2,A.P F 5,21,28,1,3,4,32
1303,5,"K&K 2,3,4,6",5,"K&K 2,3",0,K&K 4,0,K&K 6,2,"A.P F 3,4",0,A.P F 5,9,14,13,5,18,32
1304,7,"K&K 2,3,4,6",5,"K&K 2,3",5,K&K 4,11,K&K 6,3,"A.P F 3,4",0,A.P F 5,31,38,3,4,7,45
1305,41,"K&K 2,3,4,6",10,"K&K 2,3",10,K&K 4,8,K&K 6,12,"A.P F 3,4",0,A.P F 5,52,93,18,17,35,128
1306,0,"K&K 2,3,4,6",2,"K&K 2,3",2,K&K 4,2,K&K 6,4,"A.P F 3,4",2,A.P F 5,12,12,3,0,3,15
1307,0,"K&K 2,3,4,6",0,"K&K 2,3",0,K&K 4,0,K&K 6,0,"A.P F 3,4",0,A.P F 5,0,0,0,0,0,0
1308,18,"K&K 2,3,4,6",8,"K&K 2,3",8,K&K 4,4,K&K 6,15,"A.P F 3,4",14,A.P F 5,59,77,25,31,56,133
1309,35,"K&K 2,3,4,6",13,"K&K 2,3",14,K&K 4,15,K&K 6,10,"A.P F 3,4",10,A.P F 5,68,103,18,25,43,146
1310,20,"K&K 2,3,4,6",5,"K&K 2,3",3,K&K 4,5,K&K 6,9,"A.P F 3,4",5,A.P F 5,32,52,15,10,25,77
1311,22,"K&K 2,3,4,6",14,"K&K 2,3",11,K&K 4,9,K&K 6,12,"A.P F 3,4",14,A.P F 5,67,89,18,13,31,120
1312,8,"K&K 2,3,4,6",2,"K&K 2,3",0,K&K 4,8,K&K 6,2,"A.P F 3,4",7,A.P F 5,24,32,0,2,2,34
1313,40,"K&K 2,3,4,6",5,"K&K 2,3",14,K&K 4,15,K&K 6,14,"A.P F 3,4",3,A.P F 5,65,105,19,14,33,138
1314,25,"K&K 2,3,4,6",6,"K&K 2,3",12,K&K 4,15,K&K 6,14,"A.P F 3,4",5,A.P F 5,63,88,18,8,26,114
1315,45,"K&K 2,3,4,6",11,"K&K 2,3",13,K&K 4,11,K&K 6,15,"A.P F 3,4",14,A.P F 5,70,115,28,38,66,181
1316,20,"K&K 2,3,4,6",5,"K&K 2,3",8,K&K 4,10,K&K 6,10,"A.P F 3,4",10,A.P F 5,50,70,12,4,16,86
1317,19,"K&K 2,3,4,6",10,"K&K 2,3",11,K&K 4,10,K&K 6,8,"A.P F 3,4",4,A.P F 5,51,70,12,15,27,97
1318,9,"K&K 2,3,4,6",5,"K&K 2,3",9,K&K 4,13,K&K 6,8,"A.P F 3,4",11,A.P F 5,54,63,10,6,16,79
1319,28,"K&K 2,3,4,6",6,"K&K 2,3",8,K&K 4,2,K&K 6,0,"A.P F 3,4",0,A.P F 5,20,48,9,2,11,59
1320,5,"K&K 2,3,4,6",2,"K&K 2,3",4,K&K 4,5,K&K 6,3,"A.P F 3,4",2,A.P F 5,18,23,10,12,22,45
1321,40,"K&K 2,3,4,6",13,"K&K 2,3",13,K&K 4,11,K&K 6,15,"A.P F 3,4",2,A.P F 5,68,108,29,30,59,167
1322,43,"K&K 2,3,4,6",12,"K&K 2,3",8,K&K 4,14,K&K 6,7,"A.P F 3,4",14,A.P F 5,65,108,32,41,73,181
1323,63,"K&K 2,3,4,6",14,"K&K 2,3",10,K&K 4,12,K&K 6,12,"A.P F 3,4",13,A.P F 5,67,130,21,13,34,164
1324,9,"K&K 2,3,4,6",10,"K&K 2,3",8,K&K 4,14,K&K 6,11,"A.P F 3,4",10,A.P F 5,60,69,14,28,42,111
1325,6,"K&K 2,3,4,6",2,"K&K 2,3",5,K&K 4,14,K&K 6,0,"A.P F 3,4",0,A.P F 5,27,33,5,3,8,41
1326,35,"K&K 2,3,4,6",4,"K&K 2,3",11,K&K 4,6,K&K 6,8,"A.P F 3,4",3,A.P F 5,38,73,22,9,31,104
1327,8,"K&K 2,3,4,6",7,"K&K 2,3",2,K&K 4,10,K&K 6,15,"A.P F 3,4",6,A.P F 5,50,58,9,11,20,78
1328,3,"K&K 2,3,4,6",1,"K&K 2,3",1,K&K 4,2,K&K 6,2,"A.P F 3,4",2,A.P F 5,7,10,6,4,10,20
1329,43,"K&K 2,3,4,6",11,"K&K 2,3",10,K&K 4,13,K&K 6,15,"A.P F 3,4",14,A.P F 5,70,113,26,26,52,165
1330,5,"K&K 2,3,4,6",0,"K&K 2,3",0,K&K 4,15,K&K 6,2,"A.P F 3,4",0,A.P F 5,23,28,7,0,7,35
1331,14,"K&K 2,3,4,6",9,"K&K 2,3",6,K&K 4,10,K&K 6,11,"A.P F 3,4",6,A.P F 5,48,62,27,10,37,99
1332,74,"K&K 2,3,4,6",11,"K&K 2,3",15,K&K 4,15,K&K 6,15,"A.P F 3,4",14,A.P F 5,78,152,24,34,58,210
1333,0,"K&K 2,3,4,6",2,"K&K 2,3",0,K&K 4,0,K&K 6,0,"A.P F 3,4",0,A.P F 5,3,3,0,0,0,3
1334,7,"K&K 2,3,4,6",2,"K&K 2,3",2,K&K 4,13,K&K 6,3,"A.P F 3,4",2,A.P F 5,27,34,7,5,12,46
1335,11,"K&K 2,3,4,6",9,"K&K 2,3",4,K&K 4,6,K&K 6,3,"A.P F 3,4",2,A.P F 5,29,40,,,0,40
1336,21,"K&K 2,3,4,6",5,"K&K 2,3",11,K&K 4,4,K&K 6,15,"A.P F 3,4",2,A.P F 5,46,67,14,16,30,97
1337,7,"K&K 2,3,4,6",11,"K&K 2,3",6,K&K 4,15,K&K 6,10,"A.P F 3,4",11,A.P F 5,61,68,6,13,19,87
1338,15,"K&K 2,3,4,6",9,"K&K 2,3",7,K&K 4,0,K&K 6,0,"A.P F 3,4",5,A.P F 5,28,43,13,8,21,64
1339,22,"K&K 2,3,4,6",11,"K&K 2,3",11,K&K 4,5,K&K 6,13,"A.P F 3,4",6,A.P F 5,54,76,12,15,27,103
1340,26,"K&K 2,3,4,6",12,"K&K 2,3",11,K&K 4,7,K&K 6,9,"A.P F 3,4",7,A.P F 5,51,77,18,18,36,113
1341,40,"K&K 2,3,4,6",14,"K&K 2,3",8,K&K 4,15,K&K 6,12,"A.P F 3,4",14,A.P F 5,73,113,33,35,68,181
1342,56,"K&K 2,3,4,6",11,"K&K 2,3",14,K&K 4,14,K&K 6,15,"A.P F 3,4",11,A.P F 5,72,128,35,33,68,196
1343,25,"K&K 2,3,4,6",11,"K&K 2,3",9,K&K 4,13,K&K 6,15,"A.P F 3,4",13,A.P F 5,68,93,26,23,49,142
1344,15,"K&K 2,3,4,6",8,"K&K 2,3",11,K&K 4,13,K&K 6,5,"A.P F 3,4",0,A.P F 5,48,63,10,14,24,87
1345,38,"K&K 2,3,4,6",12,"K&K 2,3",8,K&K 4,15,K&K 6,15,"A.P F 3,4",9,A.P F 5,68,106,21,11,32,138
1346,12,"K&K 2,3,4,6",13,"K&K 2,3",9,K&K 4,9,K&K 6,14,"A.P F 3,4",6,A.P F 5,60,71,18,12,30,101
1347,27,"K&K 2,3,4,6",7,"K&K 2,3",5,K&K 4,9,K&K 6,10,"A.P F 3,4",8,A.P F 5,44,71,15,23,38,109
1348,7,"K&K 2,3,4,6",2,"K&K 2,3",4,K&K 4,2,K&K 6,5,"A.P F 3,4",4,A.P F 5,20,27,3,3,6,33
1349,43,"K&K 2,3,4,6",13,"K&K 2,3",11,K&K 4,5,K&K 6,5,"A.P F 3,4",8,A.P F 5,48,91,20,14,34,125
1350,28,"K&K 2,3,4,6",1,"K&K 2,3",11,K&K 4,8,K&K 6,8,"A.P F 3,4",8,A.P F 5,46,74,6,11,17,91
1351,3,"K&K 2,3,4,6",8,"K&K 2,3",0,K&K 4,9,K&K 6,6,"A.P F 3,4",2,A.P F 5,33,36,9,8,17,53
1352,29,"K&K 2,3,4,6",12,"K&K 2,3",12,K&K 4,10,K&K 6,15,"A.P F 3,4",5,A.P F 5,65,94,21,21,42,136
1353,0,"K&K 2,3,4,6",0,"K&K 2,3",0,K&K 4,0,K&K 6,0,"A.P F 3,4",0,A.P F 5,0,0,3,2,5,5
1354,11,"K&K 2,3,4,6",0,"K&K 2,3",8,K&K 4,4,K&K 6,5,"A.P F 3,4",8,A.P F 5,33,44,13,7,20,64
1355,15,"K&K 2,3,4,6",6,"K&K 2,3",8,K&K 4,8,K&K 6,14,"A.P F 3,4",0,A.P F 5,49,64,12,17,29,93
1356,53,"K&K 2,3,4,6",15,"K&K 2,3",15,K&K 4,9,K&K 6,14,"A.P F 3,4",10,A.P F 5,71,124,30,36,66,190
1357,13,"K&K 2,3,4,6",2,"K&K 2,3",9,K&K 4,0,K&K 6,11,"A.P F 3,4",2,A.P F 5,31,44,19,11,30,74
1358,12,"K&K 2,3,4,6",6,"K&K 2,3",13,K&K 4,12,K&K 6,11,"A.P F 3,4",3,A.P F 5,56,68,19,14,33,101
1359,41,"K&K 2,3,4,6",7,"K&K 2,3",11,K&K 4,15,K&K 6,13,"A.P F 3,4",14,A.P F 5,70,111,24,27,51,162
1360,24,"K&K 2,3,4,6",9,"K&K 2,3",12,K&K 4,12,K&K 6,0,"A.P F 3,4",3,A.P F 5,48,72,29,33,62,134
1361,7,"K&K 2,3,4,6",4,"K&K 2,3",7,K&K 4,10,K&K 6,0,"A.P F 3,4",9,A.P F 5,39,46,5,2,7,53
1362,16,"K&K 2,3,4,6",0,"K&K 2,3",2,K&K 4,11,K&K 6,6,"A.P F 3,4",5,A.P F 5,32,48,8,10,18,66
1363,24,"K&K 2,3,4,6",11,"K&K 2,3",9,K&K 4,9,K&K 6,13,"A.P F 3,4",7,A.P F 5,56,80,15,16,31,111
1364,44,"K&K 2,3,4,6",12,"K&K 2,3",11,K&K 4,11,K&K 6,15,"A.P F 3,4",10,A.P F 5,65,109,27,15,42,151
1365,15,"K&K 2,3,4,6",10,"K&K 2,3",9,K&K 4,9,K&K 6,5,"A.P F 3,4",3,A.P F 5,44,59,23,15,38,97
1366,12,"K&K 2,3,4,6",14,"K&K 2,3",11,K&K 4,7,K&K 6,15,"A.P F 3,4",8,A.P F 5,64,76,21,32,53,129
1367,42,"K&K 2,3,4,6",15,"K&K 2,3",13,K&K 4,13,K&K 6,11,"A.P F 3,4",9,A.P F 5,69,111,30,25,55,166
1368,13,"K&K 2,3,4,6",11,"K&K 2,3",3,K&K 4,5,K&K 6,3,"A.P F 3,4",0,A.P F 5,30,43,9,8,17,60
1369,37,"K&K 2,3,4,6",9,"K&K 2,3",10,K&K 4,12,K&K 6,15,"A.P F 3,4",4,A.P F 5,61,98,18,32,50,148
1370,15,"K&K 2,3,4,6",0,"K&K 2,3",0,K&K 4,0,K&K 6,0,"A.P F 3,4",0,A.P F 5,0,15,6,0,6,21
1371,44,"K&K 2,3,4,6",11,"K&K 2,3",9,K&K 4,8,K&K 6,15,"A.P F 3,4",9,A.P F 5,59,103,24,22,46,149
1372,10,"K&K 2,3,4,6",14,"K&K 2,3",13,K&K 4,11,K&K 6,15,"A.P F 3,4",6,A.P F 5,70,80,29,18,47,127
1373,47,"K&K 2,3,4,6",13,"K&K 2,3",8,K&K 4,9,K&K 6,9,"A.P F 3,4",14,A.P F 5,60,107,13,18,31,138
1374,37,"K&K 2,3,4,6",10,"K&K 2,3",10,K&K 4,14,K&K 6,15,"A.P F 3,4",15,A.P F 5,71,108,25,34,59,167
1375,7,"K&K 2,3,4,6",3,"K&K 2,3",3,K&K 4,15,K&K 6,2,"A.P F 3,4",8,A.P F 5,40,47,6,4,10,57
1376,35,"K&K 2,3,4,6",8,"K&K 2,3",8,K&K 4,15,K&K 6,15,"A.P F 3,4",14,A.P F 5,69,104,23,10,33,137
1377,40,"K&K 2,3,4,6",12,"K&K 2,3",7,K&K 4,15,K&K 6,15,"A.P F 3,4",10,A.P F 5,69,109,27,44,71,180
1378,6,"K&K 2,3,4,6",8,"K&K 2,3",8,K&K 4,11,K&K 6,4,"A.P F 3,4",9,A.P F 5,48,54,9,13,22,76
1379,53,"K&K 2,3,4,6",7,"K&K 2,3",13,K&K 4,11,K&K 6,2,"A.P F 3,4",5,A.P F 5,47,100,24,20,44,144
1380,24,"K&K 2,3,4,6",5,"K&K 2,3",9,K&K 4,9,K&K 6,9,"A.P F 3,4",8,A.P F 5,46,70,22,13,35,105
1381,15,"K&K 2,3,4,6",5,"K&K 2,3",8,K&K 4,7,K&K 6,14,"A.P F 3,4",3,A.P F 5,44,59,12,21,33,92
1382,50,"K&K 2,3,4,6",11,"K&K 2,3",10,K&K 4,14,K&K 6,14,"A.P F 3,4",8,A.P F 5,65,115,32,22,54,169
1383,1,"K&K 2,3,4,6",5,"K&K 2,3",2,K&K 4,3,K&K 6,14,"A.P F 3,4",2,A.P F 5,32,33,21,8,29,62
1384,55,"K&K 2,3,4,6",14,"K&K 2,3",15,K&K 4,15,K&K 6,15,"A.P F 3,4",0,A.P F 5,78,133,28,21,49,182
1385,70,"K&K 2,3,4,6",11,"K&K 2,3",14,K&K 4,9,K&K 6,15,"A.P F 3,4",6,A.P F 5,64,134,24,26,50,184
1386,34,"K&K 2,3,4,6",10,"K&K 2,3",12,K&K 4,15,K&K 6,9,"A.P F 3,4",14,A.P F 5,68,102,21,29,50,152
1387,24,"K&K 2,3,4,6",8,"K&K 2,3",6,K&K 4,0,K&K 6,7,"A.P F 3,4",3,A.P F 5,31,55,3,13,16,71
1388,5,"K&K 2,3,4,6",5,"K&K 2,3",2,K&K 4,13,K&K 6,2,"A.P F 3,4",8,A.P F 5,36,41,6,0,6,47
1389,0,"K&K 2,3,4,6",2,"K&K 2,3",2,K&K 4,8,K&K 6,2,"A.P F 3,4",2,A.P F 5,18,18,0,1,1,19
1390,23,"K&K 2,3,4,6",13,"K&K 2,3",14,K&K 4,12,K&K 6,12,"A.P F 3,4",8,A.P F 5,69,91,21,36,57,148
1391,57,"K&K 2,3,4,6",12,"K&K 2,3",13,K&K 4,15,K&K 6,10,"A.P F 3,4",5,A.P F 5,66,123,23,17,40,163
1392,9,"K&K 2,3,4,6",7,"K&K 2,3",12,K&K 4,8,K&K 6,6,"A.P F 3,4",2,A.P F 5,44,53,9,1,10,63
1393,9,"K&K 2,3,4,6",10,"K&K 2,3",11,K&K 4,9,K&K 6,9,"A.P F 3,4",6,A.P F 5,52,61,15,10,25,86
1394,37,"K&K 2,3,4,6",8,"K&K 2,3",9,K&K 4,13,K&K 6,12,"A.P F 3,4",4,A.P F 5,56,93,22,19,41,134
1395,39,"K&K 2,3,4,6",9,"K&K 2,3",13,K&K 4,13,K&K 6,15,"A.P F 3,4",14,A.P F 5,72,111,29,21,50,161
1396,8,"K&K 2,3,4,6",8,"K&K 2,3",9,K&K 4,0,K&K 6,15,"A.P F 3,4",9,A.P F 5,55,63,40,25,65,128
1397,55,"K&K 2,3,4,6",14,"K&K 2,3",11,K&K 4,15,K&K 6,0,"A.P F 3,4",2,A.P F 5,55,110,27,18,45,155
1398,14,"K&K 2,3,4,6",10,"K&K 2,3",6,K&K 4,5,K&K 6,15,"A.P F 3,4",9,A.P F 5,53,67,11,20,31,98
1399,12,"K&K 2,3,4,6",9,"K&K 2,3",10,K&K 4,10,K&K 6,15,"A.P F 3,4",4,A.P F 5,58,70,24,16,40,110
1400,32,"K&K 2,3,4,6",14,"K&K 2,3",14,K&K 4,7,K&K 6,8,"A.P F 3,4",1,A.P F 5,57,89,18,12,30,119
1401,54,"K&K 2,3,4,6",5,"K&K 2,3",11,K&K 4,15,K&K 6,15,"A.P F 3,4",2,A.P F 5,62,116,30,31,61,177
1402,12,"K&K 2,3,4,6",3,"K&K 2,3",0,K&K 4,13,K&K 6,15,"A.P F 3,4",1,A.P F 5,42,54,1,9,10,64
1403,15,"K&K 2,3,4,6",8,"K&K 2,3",11,K&K 4,11,K&K 6,10,"A.P F 3,4",0,A.P F 5,53,68,14,10,24,92
1404,26,"K&K 2,3,4,6",15,"K&K 2,3",9,K&K 4,11,K&K 6,15,"A.P F 3,4",12,A.P F 5,70,96,15,29,44,140
1405,50,"K&K 2,3,4,6",6,"K&K 2,3",12,K&K 4,6,K&K 6,0,"A.P F 3,4",0,A.P F 5,32,82,9,12,21,103
1406,6,"K&K 2,3,4,6",5,"K&K 2,3",8,K&K 4,8,K&K 6,2,"A.P F 3,4",7,A.P F 5,36,42,8,3,11,53
1407,50,"K&K 2,3,4,6",14,"K&K 2,3",12,K&K 4,15,K&K 6,5,"A.P F 3,4",8,A.P F 5,64,114,24,30,54,168
1408,3,"K&K 2,3,4,6",11,"K&K 2,3",9,K&K 4,0,K&K 6,0,"A.P F 3,4",0,A.P F 5,26,29,4,1,5,34
1409,6,"K&K 2,3,4,6",10,"K&K 2,3",7,K&K 4,14,K&K 6,9,"A.P F 3,4",1,A.P F 5,52,58,6,13,19,77
1410,5,"K&K 2,3,4,6",5,"K&K 2,3",6,K&K 4,14,K&K 6,15,"A.P F 3,4",2,A.P F 5,52,57,15,9,24,81
1411,11,"K&K 2,3,4,6",3,"K&K 2,3",13,K&K 4,14,K&K 6,14,"A.P F 3,4",8,A.P F 5,64,75,23,13,36,111
1412,6,"K&K 2,3,4,6",5,"K&K 2,3",5,K&K 4,2,K&K 6,6,"A.P F 3,4",3,A.P F 5,24,30,0,16,16,46
1413,49,"K&K 2,3,4,6",8,"K&K 2,3",11,K&K 4,5,K&K 6,15,"A.P F 3,4",10,A.P F 5,58,107,18,21,39,146
1414,9,"K&K 2,3,4,6",11,"K&K 2,3",8,K&K 4,14,K&K 6,15,"A.P F 3,4",4,A.P F 5,65,74,15,13,28,102
1415,0,"K&K 2,3,4,6",0,"K&K 2,3",3,K&K 4,0,K&K 6,0,"A.P F 3,4",8,A.P F 5,14,14,0,0,0,14
1416,7,"K&K 2,3,4,6",8,"K&K 2,3",6,K&K 4,0,K&K 6,9,"A.P F 3,4",5,A.P F 5,36,43,3,9,12,55
1417,7,"K&K 2,3,4,6",9,"K&K 2,3",12,K&K 4,4,K&K 6,14,"A.P F 3,4",0,A.P F 5,52,59,14,21,35,94
1418,46,"K&K 2,3,4,6",8,"K&K 2,3",8,K&K 4,8,K&K 6,14,"A.P F 3,4",3,A.P F 5,50,96,18,14,32,128
1419,4,"K&K 2,3,4,6",7,"K&K 2,3",11,K&K 4,11,K&K 6,12,"A.P F 3,4",1,A.P F 5,55,58,10,9,19,77
1420,15,"K&K 2,3,4,6",12,"K&K 2,3",10,K&K 4,15,K&K 6,8,"A.P F 3,4",9,A.P F 5,60,75,15,11,26,101
1421,28,"K&K 2,3,4,6",11,"K&K 2,3",14,K&K 4,12,K&K 6,15,"A.P F 3,4",4,A.P F 5,69,97,21,14,35,132
1422,36,"K&K 2,3,4,6",0,"K&K 2,3",8,K&K 4,15,K&K 6,15,"A.P F 3,4",3,A.P F 5,54,90,32,24,56,146
1423,12,"K&K 2,3,4,6",8,"K&K 2,3",0,K&K 4,0,K&K 6,0,"A.P F 3,4",0,A.P F 5,11,23,10,0,10,33
1424,49,"K&K 2,3,4,6",11,"K&K 2,3",10,K&K 4,11,K&K 6,15,"A.P F 3,4",14,A.P F 5,68,117,12,12,24,141
1425,13,"K&K 2,3,4,6",8,"K&K 2,3",0,K&K 4,13,K&K 6,5,"A.P F 3,4",2,A.P F 5,35,48,12,15,27,75
1426,27,"K&K 2,3,4,6",11,"K&K 2,3",9,K&K 4,15,K&K 6,15,"A.P F 3,4",8,A.P F 5,67,94,24,23,47,141
1427,26,"K&K 2,3,4,6",10,"K&K 2,3",15,K&K 4,15,K&K 6,8,"A.P F 3,4",5,A.P F 5,64,90,26,17,43,133
1428,36,"K&K 2,3,4,6",11,"K&K 2,3",6,K&K 4,14,K&K 6,15,"A.P F 3,4",13,A.P F 5,71,107,24,23,47,154
1429,7,"K&K 2,3,4,6",11,"K&K 2,3",10,K&K 4,15,K&K 6,13,"A.P F 3,4",2,A.P F 5,65,72,11,10,21,93
1430,7,"K&K 2,3,4,6",12,"K&K 2,3",6,K&K 4,7,K&K 6,11,"A.P F 3,4",11,A.P F 5,55,62,11,12,23,85
1431,7,"K&K 2,3,4,6",8,"K&K 2,3",0,K&K 4,11,K&K 6,0,"A.P F 3,4",0,A.P F 5,24,31,10,5,15,46
1432,29,"K&K 2,3,4,6",5,"K&K 2,3",11,K&K 4,0,K&K 6,14,"A.P F 3,4",4,A.P F 5,45,74,9,16,25,99
1433,32,"K&K 2,3,4,6",10,"K&K 2,3",11,K&K 4,13,K&K 6,15,"A.P F 3,4",15,A.P F 5,72,104,31,23,54,158
1434,39,"K&K 2,3,4,6",8,"K&K 2,3",11,K&K 4,10,K&K 6,8,"A.P F 3,4",9,A.P F 5,51,90,30,31,61,151
1435,7,"K&K 2,3,4,6",0,"K&K 2,3",11,K&K 4,8,K&K 6,6,"A.P F 3,4",8,A.P F 5,44,51,16,7,23,74
1436,19,"K&K 2,3,4,6",11,"K&K 2,3",15,K&K 4,11,K&K 6,15,"A.P F 3,4",8,A.P F 5,69,88,26,21,47,135
1437,14,"K&K 2,3,4,6",5,"K&K 2,3",11,K&K 4,14,K&K 6,12,"A.P F 3,4",3,A.P F 5,55,69,20,13,33,102
1438,0,"K&K 2,3,4,6",3,"K&K 2,3",1,K&K 4,5,K&K 6,2,"A.P F 3,4",2,A.P F 5,16,16,0,0,0,16
1439,6,"K&K 2,3,4,6",4,"K&K 2,3",5,K&K 4,13,K&K 6,14,"A.P F 3,4",2,A.P F 5,46,52,7,18,25,77
1440,0,"K&K 2,3,4,6",2,"K&K 2,3",3,K&K 4,0,K&K 6,4,"A.P F 3,4",8,A.P F 5,21,21,8,6,14,35
1441,12,"K&K 2,3,4,6",11,"K&K 2,3",12,K&K 4,15,K&K 6,9,"A.P F 3,4",0,A.P F 5,63,75,13,9,22,97
1442,8,"K&K 2,3,4,6",8,"K&K 2,3",0,K&K 4,13,K&K 6,14,"A.P F 3,4",9,A.P F 5,58,66,15,18,33,99
1443,7,"K&K 2,3,4,6",0,"K&K 2,3",0,K&K 4,8,K&K 6,0,"A.P F 3,4",2,A.P F 5,12,19,9,11,20,39
1444,9,"K&K 2,3,4,6",11,"K&K 2,3",7,K&K 4,10,K&K 6,9,"A.P F 3,4",0,A.P F 5,49,58,14,8,22,80
1445,4,"K&K 2,3,4,6",0,"K&K 2,3",2,K&K 4,0,K&K 6,1,"A.P F 3,4",8,A.P F 5,14,18,15,6,21,39
1446,12,"K&K 2,3,4,6",5,"K&K 2,3",6,K&K 4,11,K&K 6,8,"A.P F 3,4",9,A.P F 5,45,57,4,19,23,80
1447,15,"K&K 2,3,4,6",14,"K&K 2,3",11,K&K 4,11,K&K 6,14,"A.P F 3,4",13,A.P F 5,69,84,20,12,32,116
1448,15,"K&K 2,3,4,6",13,"K&K 2,3",8,K&K 4,9,K&K 6,15,"A.P F 3,4",12,A.P F 5,65,80,13,9,22,102
1449,5,"K&K 2,3,4,6",2,"K&K 2,3",6,K&K 4,15,K&K 6,9,"A.P F 3,4",6,A.P F 5,48,53,18,1,19,72
1450,20,"K&K 2,3,4,6",11,"K&K 2,3",14,K&K 4,15,K&K 6,15,"A.P F 3,4",7,A.P F 5,72,92,16,23,39,131
1451,10,"K&K 2,3,4,6",10,"K&K 2,3",8,K&K 4,15,K&K 6,15,"A.P F 3,4",4,A.P F 5,63,73,15,7,22,95
1452,13,"K&K 2,3,4,6",5,"K&K 2,3",0,K&K 4,11,K&K 6,9,"A.P F 3,4",0,A.P F 5,33,46,3,5,8,54
1453,13,"K&K 2,3,4,6",8,"K&K 2,3",11,K&K 4,3,K&K 6,8,"A.P F 3,4",2,A.P F 5,39,52,12,20,32,84
1454,23,"K&K 2,3,4,6",10,"K&K 2,3",0,K&K 4,11,K&K 6,8,"A.P F 3,4",5,A.P F 5,45,68,12,11,23,91
1455,26,"K&K 2,3,4,6",4,"K&K 2,3",10,K&K 4,2,K&K 6,15,"A.P F 3,4",3,A.P F 5,42,68,21,14,35,103
1456,24,"K&K 2,3,4,6",10,"K&K 2,3",4,K&K 4,2,K&K 6,0,"A.P F 3,4",5,A.P F 5,28,52,7,11,18,70
1457,13,"K&K 2,3,4,6",3,"K&K 2,3",8,K&K 4,8,K&K 6,11,"A.P F 3,4",9,A.P F 5,47,60,13,8,21,81
1458,22,"K&K 2,3,4,6",8,"K&K 2,3",5,K&K 4,2,K&K 6,15,"A.P F 3,4",8,A.P F 5,48,70,21,17,38,108
1459,10,"K&K 2,3,4,6",11,"K&K 2,3",9,K&K 4,5,K&K 6,15,"A.P F 3,4",2,A.P F 5,54,64,19,15,34,98
1460,19,"K&K 2,3,4,6",0,"K&K 2,3",2,K&K 4,12,K&K 6,5,"A.P F 3,4",8,A.P F 5,36,55,0,7,7,62
1461,13,"K&K 2,3,4,6",7,"K&K 2,3",9,K&K 4,15,K&K 6,13,"A.P F 3,4",14,A.P F 5,68,81,22,13,35,116
1462,8,"K&K 2,3,4,6",11,"K&K 2,3",0,K&K 4,14,K&K 6,0,"A.P F 3,4",4,A.P F 5,39,47,15,17,32,79
1463,8,"K&K 2,3,4,6",10,"K&K 2,3",9,K&K 4,5,K&K 6,15,"A.P F 3,4",5,A.P F 5,53,61,14,9,23,84
1464,11,"K&K 2,3,4,6",8,"K&K 2,3",3,K&K 4,11,K&K 6,8,"A.P F 3,4",7,A.P F 5,44,55,12,9,21,76
1465,13,"K&K 2,3,4,6",4,"K&K 2,3",8,K&K 4,0,K&K 6,0,"A.P F 3,4",0,A.P F 5,17,30,12,17,29,59
1466,20,"K&K 2,3,4,6",8,"K&K 2,3",2,K&K 4,4,K&K 6,11,"A.P F 3,4",5,A.P F 5,37,57,19,23,42,99
1467,27,"K&K 2,3,4,6",11,"K&K 2,3",10,K&K 4,10,K&K 6,13,"A.P F 3,4",0,A.P F 5,58,85,34,24,58,143
1468,40,"K&K 2,3,4,6",15,"K&K 2,3",11,K&K 4,12,K&K 6,15,"A.P F 3,4",4,A.P F 5,71,111,13,17,30,141
1469,13,"K&K 2,3,4,6",7,"K&K 2,3",9,K&K 4,14,K&K 6,15,"A.P F 3,4",11,A.P F 5,65,78,19,15,34,112
1470,21,"K&K 2,3,4,6",7,"K&K 2,3",9,K&K 4,10,K&K 6,11,"A.P F 3,4",4,A.P F 5,49,70,21,8,29,99
1471,29,"K&K 2,3,4,6",5,"K&K 2,3",11,K&K 4,14,K&K 6,6,"A.P F 3,4",2,A.P F 5,47,76,32,14,46,122
1472,10,"K&K 2,3,4,6",14,"K&K 2,3",11,K&K 4,15,K&K 6,15,"A.P F 3,4",5,A.P F 5,72,82,21,19,40,122
1473,0,"K&K 2,3,4,6",7,"K&K 2,3",8,K&K 4,0,K&K 6,14,"A.P F 3,4",0,A.P F 5,38,38,11,12,23,61
1474,25,"K&K 2,3,4,6",11,"K&K 2,3",13,K&K 4,15,K&K 6,0,"A.P F 3,4",2,A.P F 5,54,79,21,24,45,124
1475,45,"K&K 2,3,4,6",14,"K&K 2,3",15,K&K 4,8,K&K 6,15,"A.P F 3,4",10,A.P F 5,71,116,27,22,49,165
1476,12,"K&K 2,3,4,6",0,"K&K 2,3",0,K&K 4,14,K&K 6,10,"A.P F 3,4",10,A.P F 5,44,56,15,14,29,85
1477,21,"K&K 2,3,4,6",15,"K&K 2,3",9,K&K 4,3,K&K 6,15,"A.P F 3,4",4,A.P F 5,57,78,24,19,43,121
1478,39,"K&K 2,3,4,6",7,"K&K 2,3",11,K&K 4,5,K&K 6,15,"A.P F 3,4",4,A.P F 5,50,89,21,20,41,130
1479,49,"K&K 2,3,4,6",11,"K&K 2,3",11,K&K 4,9,K&K 6,3,"A.P F 3,4",3,A.P F 5,46,95,29,44,73,168
1480,7,"K&K 2,3,4,6",4,"K&K 2,3",5,K&K 4,3,K&K 6,14,"A.P F 3,4",4,A.P F 5,36,43,6,8,14,57
1481,4,"K&K 2,3,4,6",6,"K&K 2,3",2,K&K 4,0,K&K 6,0,"A.P F 3,4",0,A.P F 5,10,14,3,0,3,17
1482,12,"K&K 2,3,4,6",2,"K&K 2,3",9,K&K 4,10,K&K 6,0,"A.P F 3,4",6,A.P F 5,36,48,7,12,19,67
1483,24,"K&K 2,3,4,6",8,"K&K 2,3",4,K&K 4,6,K&K 6,5,"A.P F 3,4",5,A.P F 5,30,54,17,10,27,81
1484,47,"K&K 2,3,4,6",8,"K&K 2,3",9,K&K 4,14,K&K 6,11,"A.P F 3,4",15,A.P F 5,64,111,29,20,49,160
1485,8,"K&K 2,3,4,6",2,"K&K 2,3",8,K&K 4,15,K&K 6,0,"A.P F 3,4",0,A.P F 5,33,41,0,17,17,58
1486,10,"K&K 2,3,4,6",9,"K&K 2,3",9,K&K 4,1,K&K 6,7,"A.P F 3,4",12,A.P F 5,49,59,24,21,45,104
1487,25,"K&K 2,3,4,6",6,"K&K 2,3",13,K&K 4,8,K&K 6,15,"A.P F 3,4",8,A.P F 5,59,84,20,27,47,131
1488,47,"K&K 2,3,4,6",9,"K&K 2,3",12,K&K 4,15,K&K 6,15,"A.P F 3,4",10,A.P F 5,69,116,26,17,43,159
1489,15,"K&K 2,3,4,6",12,"K&K 2,3",10,K&K 4,8,K&K 6,15,"A.P F 3,4",11,A.P F 5,64,79,24,22,46,125
1490,31,"K&K 2,3,4,6",12,"K&K 2,3",11,K&K 4,15,K&K 6,15,"A.P F 3,4",11,A.P F 5,71,102,22,20,42,144
1491,6,"K&K 2,3,4,6",6,"K&K 2,3",2,K&K 4,3,K&K 6,2,"A.P F 3,4",2,A.P F 5,17,23,6,6,12,35
1492,14,"K&K 2,3,4,6",8,"K&K 2,3",8,K&K 4,9,K&K 6,15,"A.P F 3,4",1,A.P F 5,53,67,20,14,34,101
1493,2,"K&K 2,3,4,6",2,"K&K 2,3",1,K&K 4,1,K&K 6,1,"A.P F 3,4",1,A.P F 5,5,7,3,0,3,10
1494,25,"K&K 2,3,4,6",10,"K&K 2,3",7,K&K 4,13,K&K 6,12,"A.P F 3,4",4,A.P F 5,55,80,27,26,53,133
1495,4,"K&K 2,3,4,6",1,"K&K 2,3",4,K&K 4,1,K&K 6,1,"A.P F 3,4",2,A.P F 5,9,13,1,0,1,14
1496,12,"K&K 2,3,4,6",0,"K&K 2,3",5,K&K 4,15,K&K 6,9,"A.P F 3,4",8,A.P F 5,48,60,19,6,25,85
1497,42,"K&K 2,3,4,6",5,"K&K 2,3",0,K&K 4,6,K&K 6,8,"A.P F 3,4",11,A.P F 5,41,83,24,15,39,122
1498,68,"K&K 2,3,4,6",13,"K&K 2,3",14,K&K 4,15,K&K 6,15,"A.P F 3,4",14,A.P F 5,76,144,25,25,50,194
1499,22,"K&K 2,3,4,6",14,"K&K 2,3",9,K&K 4,13,K&K 6,15,"A.P F 3,4",8,A.P F 5,68,90,37,32,69,159
1500,5,"K&K 2,3,4,6",1,"K&K 2,3",8,K&K 4,0,K&K 6,2,"A.P F 3,4",9,A.P F 5,25,30,0,8,8,38
1501,27,"K&K 2,3,4,6",14,"K&K 2,3",10,K&K 4,15,K&K 6,8,"A.P F 3,4",13,A.P F 5,69,96,18,21,39,135
1502,25,"K&K 2,3,4,6",9,"K&K 2,3",11,K&K 4,8,K&K 6,3,"A.P F 3,4",1,A.P F 5,41,66,18,12,30,96
1503,17,"K&K 2,3,4,6",8,"K&K 2,3",11,K&K 4,7,K&K 6,12,"A.P F 3,4",5,A.P F 5,50,67,14,9,23,90
1504,40,"K&K 2,3,4,6",12,"K&K 2,3",14,K&K 4,14,K&K 6,15,"A.P F 3,4",9,A.P F 5,74,114,30,16,46,160
1505,10,"K&K 2,3,4,6",8,"K&K 2,3",0,K&K 4,2,K&K 6,9,"A.P F 3,4",5,A.P F 5,32,42,6,10,16,58
1506,5,"K&K 2,3,4,6",0,"K&K 2,3",11,K&K 4,3,K&K 6,0,"A.P F 3,4",0,A.P F 5,18,23,3,8,11,34
1507,7,"K&K 2,3,4,6",7,"K&K 2,3",0,K&K 4,3,K&K 6,15,"A.P F 3,4",8,A.P F 5,44,51,8,8,16,67
1508,17,"K&K 2,3,4,6",12,"K&K 2,3",11,K&K 4,8,K&K 6,15,"A.P F 3,4",4,A.P F 5,62,79,32,36,68,147
1509,11,"K&K 2,3,4,6",14,"K&K 2,3",8,K&K 4,3,K&K 6,8,"A.P F 3,4",2,A.P F 5,43,54,12,7,19,73
1510,23,"K&K 2,3,4,6",8,"K&K 2,3",8,K&K 4,11,K&K 6,8,"A.P F 3,4",0,A.P F 5,47,70,3,7,10,80
1511,5,"K&K 2,3,4,6",5,"K&K 2,3",0,K&K 4,8,K&K 6,0,"A.P F 3,4",4,A.P F 5,22,27,12,4,16,43
1512,30,"K&K 2,3,4,6",3,"K&K 2,3",8,K&K 4,8,K&K 6,14,"A.P F 3,4",3,A.P F 5,42,72,17,25,42,114
1513,8,"K&K 2,3,4,6",6,"K&K 2,3",12,K&K 4,9,K&K 6,5,"A.P F 3,4",1,A.P F 5,43,51,15,18,33,84
1514,19,"K&K 2,3,4,6",11,"K&K 2,3",13,K&K 4,6,K&K 6,8,"A.P F 3,4",11,A.P F 5,56,75,24,23,47,122
1515,11,"K&K 2,3,4,6",6,"K&K 2,3",11,K&K 4,9,K&K 6,5,"A.P F 3,4",2,A.P F 5,40,51,10,10,20,71
1516,22,"K&K 2,3,4,6",2,"K&K 2,3",7,K&K 4,9,K&K 6,15,"A.P F 3,4",3,A.P F 5,45,67,13,17,30,97
1517,25,"K&K 2,3,4,6",10,"K&K 2,3",8,K&K 4,11,K&K 6,5,"A.P F 3,4",0,A.P F 5,46,71,33,9,42,113
1518,16,"K&K 2,3,4,6",8,"K&K 2,3",11,K&K 4,5,K&K 6,1,"A.P F 3,4",1,A.P F 5,32,48,15,8,23,71
1519,62,"K&K 2,3,4,6",14,"K&K 2,3",13,K&K 4,13,K&K 6,15,"A.P F 3,4",5,A.P F 5,73,135,23,23,46,181
1520,21,"K&K 2,3,4,6",8,"K&K 2,3",1,K&K 4,3,K&K 6,8,"A.P F 3,4",1,A.P F 5,25,46,13,2,15,61
1521,32,"K&K 2,3,4,6",9,"K&K 2,3",14,K&K 4,8,K&K 6,2,"A.P F 3,4",6,A.P F 5,49,81,28,4,32,113
1522,17,"K&K 2,3,4,6",5,"K&K 2,3",10,K&K 4,11,K&K 6,6,"A.P F 3,4",14,A.P F 5,53,70,20,11,31,101
1523,39,"K&K 2,3,4,6",7,"K&K 2,3",11,K&K 4,15,K&K 6,3,"A.P F 3,4",5,A.P F 5,50,89,20,13,33,122
1524,11,"K&K 2,3,4,6",11,"K&K 2,3",10,K&K 4,5,K&K 6,14,"A.P F 3,4",8,A.P F 5,55,66,21,16,37,103
1525,7,"K&K 2,3,4,6",4,"K&K 2,3",0,K&K 4,13,K&K 6,3,"A.P F 3,4",2,A.P F 5,29,36,18,9,27,63
1526,49,"K&K 2,3,4,6",8,"K&K 2,3",13,K&K 4,11,K&K 6,14,"A.P F 3,4",15,A.P F 5,70,119,33,22,55,174
1527,12,"K&K 2,3,4,6",11,"K&K 2,3",9,K&K 4,4,K&K 6,14,"A.P F 3,4",11,A.P F 5,60,72,27,21,48,120
1528,11,"K&K 2,3,4,6",8,"K&K 2,3",11,K&K 4,5,K&K 6,8,"A.P F 3,4",3,A.P F 5,42,53,9,21,30,83
1529,7,"K&K 2,3,4,6",7,"K&K 2,3",0,K&K 4,9,K&K 6,4,"A.P F 3,4",1,A.P F 5,27,34,11,19,30,64
1530,0,"K&K 2,3,4,6",3,"K&K 2,3",11,K&K 4,9,K&K 6,0,"A.P F 3,4",0,A.P F 5,32,32,6,0,6,38
1531,32,"K&K 2,3,4,6",4,"K&K 2,3",12,K&K 4,11,K&K 6,15,"A.P F 3,4",8,A.P F 5,61,93,20,10,30,123
1532,37,"K&K 2,3,4,6",14,"K&K 2,3",14,K&K 4,5,K&K 6,15,"A.P F 3,4",3,A.P F 5,65,102,22,12,34,136
1533,12,"K&K 2,3,4,6",12,"K&K 2,3",2,K&K 4,15,K&K 6,5,"A.P F 3,4",15,A.P F 5,63,75,24,22,46,121
1534,11,"K&K 2,3,4,6",5,"K&K 2,3",11,K&K 4,11,K&K 6,1,"A.P F 3,4",0,A.P F 5,37,48,16,16,32,80
1535,8,"K&K 2,3,4,6",0,"K&K 2,3",5,K&K 4,15,K&K 6,14,"A.P F 3,4",4,A.P F 5,49,57,1,4,5,62
1536,36,"K&K 2,3,4,6",8,"K&K 2,3",10,K&K 4,15,K&K 6,4,"A.P F 3,4",2,A.P F 5,49,85,11,9,20,105
1537,6,"K&K 2,3,4,6",6,"K&K 2,3",6,K&K 4,9,K&K 6,9,"A.P F 3,4",3,A.P F 5,40,46,10,8,18,64
1538,5,"K&K 2,3,4,6",1,"K&K 2,3",2,K&K 4,2,K&K 6,3,"A.P F 3,4",2,A.P F 5,11,16,4,4,8,24
1539,9,"K&K 2,3,4,6",3,"K&K 2,3",2,K&K 4,9,K&K 6,8,"A.P F 3,4",8,A.P F 5,36,45,6,8,14,59
1540,39,"K&K 2,3,4,6",10,"K&K 2,3",9,K&K 4,15,K&K 6,13,"A.P F 3,4",11,A.P F 5,64,103,29,18,47,150
1541,0,"K&K 2,3,4,6",5,"K&K 2,3",0,K&K 4,0,K&K 6,1,"A.P F 3,4",2,A.P F 5,10,10,4,1,5,15
1542,31,"K&K 2,3,4,6",11,"K&K 2,3",10,K&K 4,14,K&K 6,8,"A.P F 3,4",8,A.P F 5,58,89,20,21,41,130
1543,36,"K&K 2,3,4,6",6,"K&K 2,3",8,K&K 4,8,K&K 6,7,"A.P F 3,4",2,A.P F 5,39,75,19,22,41,116
1544,5,"K&K 2,3,4,6",5,"K&K 2,3",9,K&K 4,15,K&K 6,0,"A.P F 3,4",3,A.P F 5,43,48,8,12,20,68
1545,23,"K&K 2,3,4,6",7,"K&K 2,3",7,K&K 4,2,K&K 6,14,"A.P F 3,4",14,A.P F 5,57,80,27,20,47,127
1546,0,"K&K 2,3,4,6",3,"K&K 2,3",0,K&K 4,0,K&K 6,3,"A.P F 3,4",1,A.P F 5,9,9,0,1,1,10
1547,38,"K&K 2,3,4,6",6,"K&K 2,3",7,K&K 4,14,K&K 6,15,"A.P F 3,4",11,A.P F 5,63,101,22,23,45,146
1548,7,"K&K 2,3,4,6",12,"K&K 2,3",8,K&K 4,5,K&K 6,15,"A.P F 3,4",8,A.P F 5,57,64,16,18,34,98
1549,14,"K&K 2,3,4,6",9,"K&K 2,3",7,K&K 4,8,K&K 6,6,"A.P F 3,4",4,A.P F 5,40,54,,,0,54
1550,10,"K&K 2,3,4,6",6,"K&K 2,3",3,K&K 4,5,K&K 6,7,"A.P F 3,4",8,A.P F 5,33,43,5,14,19,62
1551,38,"K&K 2,3,4,6",8,"K&K 2,3",8,K&K 4,15,K&K 6,11,"A.P F 3,4",13,A.P F 5,62,100,15,20,35,135
1552,19,"K&K 2,3,4,6",15,"K&K 2,3",11,K&K 4,14,K&K 6,14,"A.P F 3,4",8,A.P F 5,71,90,15,13,28,118
1553,4,"K&K 2,3,4,6",3,"K&K 2,3",7,K&K 4,10,K&K 6,2,"A.P F 3,4",0,A.P F 5,28,32,3,2,5,37
1554,17,"K&K 2,3,4,6",6,"K&K 2,3",1,K&K 4,0,K&K 6,2,"A.P F 3,4",2,A.P F 5,13,30,20,6,26,56
1555,12,"K&K 2,3,4,6",9,"K&K 2,3",8,K&K 4,12,K&K 6,0,"A.P F 3,4",5,A.P F 5,45,57,14,21,35,92
1556,39,"K&K 2,3,4,6",11,"K&K 2,3",12,K&K 4,11,K&K 6,11,"A.P F 3,4",0,A.P F 5,58,97,18,22,40,137
1557,33,"K&K 2,3,4,6",0,"K&K 2,3",11,K&K 4,8,K&K 6,9,"A.P F 3,4",5,A.P F 5,43,76,9,11,20,96
1558,14,"K&K 2,3,4,6",1,"K&K 2,3",1,K&K 4,8,K&K 6,3,"A.P F 3,4",1,A.P F 5,17,31,6,5,11,42
1559,26,"K&K 2,3,4,6",6,"K&K 2,3",8,K&K 4,14,K&K 6,6,"A.P F 3,4",5,A.P F 5,44,70,6,10,16,86
1560,7,"K&K 2,3,4,6",6,"K&K 2,3",7,K&K 4,7,K&K 6,8,"A.P F 3,4",1,A.P F 5,36,43,12,4,16,59
1561,24,"K&K 2,3,4,6",7,"K&K 2,3",15,K&K 4,13,K&K 6,8,"A.P F 3,4",0,A.P F 5,56,80,10,16,26,106
1562,1,"K&K 2,3,4,6",8,"K&K 2,3",1,K&K 4,14,K&K 6,11,"A.P F 3,4",2,A.P F 5,45,46,3,1,4,50
1563,39,"K&K 2,3,4,6",11,"K&K 2,3",8,K&K 4,13,K&K 6,3,"A.P F 3,4",15,A.P F 5,63,102,20,19,39,141
1564,6,"K&K 2,3,4,6",1,"K&K 2,3",2,K&K 4,8,K&K 6,2,"A.P F 3,4",3,A.P F 5,21,27,3,5,8,35
1565,5,"K&K 2,3,4,6",0,"K&K 2,3",4,K&K 4,0,K&K 6,2,"A.P F 3,4",0,A.P F 5,8,13,11,10,21,34
1566,43,"K&K 2,3,4,6",9,"K&K 2,3",13,K&K 4,12,K&K 6,2,"A.P F 3,4",5,A.P F 5,52,95,28,23,51,146
1567,9,"K&K 2,3,4,6",0,"K&K 2,3",5,K&K 4,13,K&K 6,9,"A.P F 3,4",8,A.P F 5,47,56,5,5,10,66
1568,10,"K&K 2,3,4,6",4,"K&K 2,3",9,K&K 4,14,K&K 6,9,"A.P F 3,4",14,A.P F 5,62,72,14,15,29,101
1569,29,"K&K 2,3,4,6",5,"K&K 2,3",4,K&K 4,11,K&K 6,8,"A.P F 3,4",7,A.P F 5,42,71,1,1,2,73
1570,15,"K&K 2,3,4,6",3,"K&K 2,3",4,K&K 4,9,K&K 6,2,"A.P F 3,4",3,A.P F 5,25,40,8,12,20,60
1571,4,"K&K 2,3,4,6",3,"K&K 2,3",8,K&K 4,7,K&K 6,12,"A.P F 3,4",3,A.P F 5,40,44,0,3,3,47
1572,30,"K&K 2,3,4,6",8,"K&K 2,3",11,K&K 4,3,K&K 6,15,"A.P F 3,4",0,A.P F 5,50,80,13,15,28,108
1573,17,"K&K 2,3,4,6",12,"K&K 2,3",11,K&K 4,9,K&K 6,6,"A.P F 3,4",0,A.P F 5,51,68,21,17,38,106
1574,31,"K&K 2,3,4,6",7,"K&K 2,3",9,K&K 4,11,K&K 6,8,"A.P F 3,4",3,A.P F 5,45,76,25,24,49,125
1575,26,"K&K 2,3,4,6",5,"K&K 2,3",12,K&K 4,13,K&K 6,8,"A.P F 3,4",7,A.P F 5,52,78,12,18,30,108
1576,42,"K&K 2,3,4,6",8,"K&K 2,3",12,K&K 4,15,K&K 6,15,"A.P F 3,4",3,A.P F 5,66,108,17,27,44,152
1577,33,"K&K 2,3,4,6",13,"K&K 2,3",13,K&K 4,15,K&K 6,4,"A.P F 3,4",2,A.P F 5,59,92,28,14,42,134
1578,15,"K&K 2,3,4,6",9,"K&K 2,3",10,K&K 4,5,K&K 6,11,"A.P F 3,4",11,A.P F 5,54,69,20,30,50,119
1579,14,"K&K 2,3,4,6",0,"K&K 2,3",8,K&K 4,5,K&K 6,11,"A.P F 3,4",1,A.P F 5,31,45,9,10,19,64
1580,5,"K&K 2,3,4,6",8,"K&K 2,3",8,K&K 4,0,K&K 6,0,"A.P F 3,4",0,A.P F 5,22,27,0,3,3,30
1581,15,"K&K 2,3,4,6",8,"K&K 2,3",10,K&K 4,10,K&K 6,7,"A.P F 3,4",0,A.P F 5,46,61,12,22,34,95
1582,12,"K&K 2,3,4,6",13,"K&K 2,3",12,K&K 4,14,K&K 6,8,"A.P F 3,4",8,A.P F 5,62,74,28,37,65,139
1583,4,"K&K 2,3,4,6",1,"K&K 2,3",0,K&K 4,0,K&K 6,0,"A.P F 3,4",2,A.P F 5,4,8,0,3,3,11
1584,9,"K&K 2,3,4,6",9,"K&K 2,3",0,K&K 4,14,K&K 6,11,"A.P F 3,4",11,A.P F 5,60,69,8,16,24,93
1585,20,"K&K 2,3,4,6",7,"K&K 2,3",9,K&K 4,11,K&K 6,15,"A.P F 3,4",2,A.P F 5,55,75,21,20,41,116
1586,18,"K&K 2,3,4,6",11,"K&K 2,3",8,K&K 4,11,K&K 6,15,"A.P F 3,4",13,A.P F 5,65,83,27,25,52,135
1587,14,"K&K 2,3,4,6",13,"K&K 2,3",14,K&K 4,13,K&K 6,15,"A.P F 3,4",6,A.P F 5,72,86,0,,0,86
1588,25,"K&K 2,3,4,6",14,"K&K 2,3",5,K&K 4,5,K&K 6,1,"A.P F 3,4",2,A.P F 5,32,57,12,10,22,79
1589,6,"K&K 2,3,4,6",0,"K&K 2,3",0,K&K 4,11,K&K 6,2,"A.P F 3,4",0,A.P F 5,16,22,0,5,5,27
1590,9,"K&K 2,3,4,6",0,"K&K 2,3",11,K&K 4,12,K&K 6,14,"A.P F 3,4",13,A.P F 5,66,75,12,19,31,106
1591,1,"K&K 2,3,4,6",1,"K&K 2,3",2,K&K 4,0,K&K 6,2,"A.P F 3,4",3,A.P F 5,9,10,3,0,3,13
1592,46,"K&K 2,3,4,6",10,"K&K 2,3",11,K&K 4,15,K&K 6,4,"A.P F 3,4",9,A.P F 5,60,106,27,11,38,144
1593,32,"K&K 2,3,4,6",7,"K&K 2,3",11,K&K 4,15,K&K 6,10,"A.P F 3,4",7,A.P F 5,56,88,18,19,37,125
1594,18,"K&K 2,3,4,6",4,"K&K 2,3",8,K&K 4,8,K&K 6,7,"A.P F 3,4",6,A.P F 5,37,55,18,25,43,98
1595,43,"K&K 2,3,4,6",14,"K&K 2,3",15,K&K 4,14,K&K 6,15,"A.P F 3,4",10,A.P F 5,76,119,18,25,43,162
1596,55,"K&K 2,3,4,6",14,"K&K 2,3",0,K&K 4,15,K&K 6,15,"A.P F 3,4",15,A.P F 5,78,133,33,31,64,197
1597,12,"K&K 2,3,4,6",4,"K&K 2,3",8,K&K 4,15,K&K 6,10,"A.P F 3,4",10,A.P F 5,57,69,10,24,34,103
1598,33,"K&K 2,3,4,6",8,"K&K 2,3",8,K&K 4,15,K&K 6,15,"A.P F 3,4",12,A.P F 5,66,99,26,30,56,155
1599,58,"K&K 2,3,4,6",9,"K&K 2,3",11,K&K 4,13,K&K 6,8,"A.P F 3,4",5,A.P F 5,53,111,20,15,35,146
1600,39,"K&K 2,3,4,6",9,"K&K 2,3",11,K&K 4,15,K&K 6,15,"A.P F 3,4",10,A.P F 5,67,106,17,24,41,147
1601,17,"K&K 2,3,4,6",12,"K&K 2,3",8,K&K 4,14,K&K 6,12,"A.P F 3,4",8,A.P F 5,61,78,9,19,28,106
1602,5,"K&K 2,3,4,6",12,"K&K 2,3",10,K&K 4,9,K&K 6,11,"A.P F 3,4",10,A.P F 5,57,62,15,18,33,95
1603,7,"K&K 2,3,4,6",5,"K&K 2,3",5,K&K 4,8,K&K 6,15,"A.P F 3,4",8,A.P F 5,49,56,15,20,35,91
1604,5,"K&K 2,3,4,6",9,"K&K 2,3",7,K&K 4,0,K&K 6,0,"A.P F 3,4",0,A.P F 5,22,27,12,10,22,49
1605,3,"K&K 2,3,4,6",2,"K&K 2,3",1,K&K 4,15,K&K 6,6,"A.P F 3,4",8,A.P F 5,40,43,0,4,4,47
1606,4,"K&K 2,3,4,6",2,"K&K 2,3",0,K&K 4,0,K&K 6,0,"A.P F 3,4",0,A.P F 5,2,6,3,1,4,10
1607,35,"K&K 2,3,4,6",5,"K&K 2,3",13,K&K 4,5,K&K 6,3,"A.P F 3,4",0,A.P F 5,35,70,26,10,36,106
1608,26,"K&K 2,3,4,6",6,"K&K 2,3",12,K&K 4,11,K&K 6,14,"A.P F 3,4",9,A.P F 5,61,87,23,22,45,132
1609,19,"K&K 2,3,4,6",8,"K&K 2,3",10,K&K 4,15,K&K 6,15,"A.P F 3,4",5,A.P F 5,63,82,15,22,37,119
1610,35,"K&K 2,3,4,6",15,"K&K 2,3",12,K&K 4,10,K&K 6,11,"A.P F 3,4",3,A.P F 5,64,99,25,19,44,143
1611,4,"K&K 2,3,4,6",2,"K&K 2,3",2,K&K 4,7,K&K 6,2,"A.P F 3,4",1,A.P F 5,16,20,3,8,11,31
1612,19,"K&K 2,3,4,6",11,"K&K 2,3",14,K&K 4,9,K&K 6,0,"A.P F 3,4",3,A.P F 5,49,68,26,16,42,110
1613,6,"K&K 2,3,4,6",9,"K&K 2,3",10,K&K 4,0,K&K 6,10,"A.P F 3,4",4,A.P F 5,43,49,15,15,30,79
1614,31,"K&K 2,3,4,6",11,"K&K 2,3",10,K&K 4,14,K&K 6,14,"A.P F 3,4",11,A.P F 5,66,97,15,30,45,142
1615,0,"K&K 2,3,4,6",1,"K&K 2,3",4,K&K 4,11,K&K 6,1,"A.P F 3,4",1,A.P F 5,21,21,3,1,4,25
1616,11,"K&K 2,3,4,6",7,"K&K 2,3",12,K&K 4,15,K&K 6,5,"A.P F 3,4",8,A.P F 5,56,67,13,21,34,101
1617,7,"K&K 2,3,4,6",9,"K&K 2,3",3,K&K 4,5,K&K 6,3,"A.P F 3,4",4,A.P F 5,27,34,9,3,12,46
1618,20,"K&K 2,3,4,6",10,"K&K 2,3",12,K&K 4,11,K&K 6,7,"A.P F 3,4",0,A.P F 5,54,74,18,18,36,110
1619,59,"K&K 2,3,4,6",11,"K&K 2,3",12,K&K 4,11,K&K 6,15,"A.P F 3,4",15,A.P F 5,70,129,29,28,57,186
1620,40,"K&K 2,3,4,6",5,"K&K 2,3",11,K&K 4,12,K&K 6,8,"A.P F 3,4",7,A.P F 5,51,91,19,19,38,129
1621,28,"K&K 2,3,4,6",8,"K&K 2,3",12,K&K 4,13,K&K 6,5,"A.P F 3,4",5,A.P F 5,51,79,24,31,55,134
1622,11,"K&K 2,3,4,6",8,"K&K 2,3",8,K&K 4,2,K&K 6,15,"A.P F 3,4",15,A.P F 5,60,71,27,17,44,115
1623,8,"K&K 2,3,4,6",11,"K&K 2,3",8,K&K 4,8,K&K 6,4,"A.P F 3,4",8,A.P F 5,45,53,22,32,54,107
1624,37,"K&K 2,3,4,6",13,"K&K 2,3",11,K&K 4,15,K&K 6,15,"A.P F 3,4",15,A.P F 5,77,114,22,37,59,173
1625,21,"K&K 2,3,4,6",7,"K&K 2,3",3,K&K 4,11,K&K 6,4,"A.P F 3,4",10,A.P F 5,41,62,22,27,49,111
1626,65,"K&K 2,3,4,6",15,"K&K 2,3",15,K&K 4,15,K&K 6,15,"A.P F 3,4",4,A.P F 5,80,145,32,30,62,207
1627,12,"K&K 2,3,4,6",8,"K&K 2,3",11,K&K 4,3,K&K 6,13,"A.P F 3,4",5,A.P F 5,50,62,15,18,33,95
1628,12,"K&K 2,3,4,6",2,"K&K 2,3",7,K&K 4,5,K&K 6,8,"A.P F 3,4",0,A.P F 5,29,41,,,0,41
1629,11,"K&K 2,3,4,6",9,"K&K 2,3",8,K&K 4,13,K&K 6,11,"A.P F 3,4",13,A.P F 5,61,72,21,17,38,110
1630,79,"K&K 2,3,4,6",11,"K&K 2,3",11,K&K 4,15,K&K 6,3,"A.P F 3,4",0,A.P F 5,53,132,26,15,41,173
1631,7,"K&K 2,3,4,6",8,"K&K 2,3",8,K&K 4,11,K&K 6,14,"A.P F 3,4",10,A.P F 5,58,65,8,15,23,88
1632,33,"K&K 2,3,4,6",0,"K&K 2,3",9,K&K 4,8,K&K 6,2,"A.P F 3,4",1,A.P F 5,25,58,21,14,35,93
1633,4,"K&K 2,3,4,6",5,"K&K 2,3",1,K&K 4,1,K&K 6,1,"A.P F 3,4",4,A.P F 5,14,18,3,0,3,21
1634,49,"K&K 2,3,4,6",10,"K&K 2,3",14,K&K 4,11,K&K 6,13,"A.P F 3,4",9,A.P F 5,62,111,31,16,47,158
1635,53,"K&K 2,3,4,6",4,"K&K 2,3",12,K&K 4,9,K&K 6,0,"A.P F 3,4",0,A.P F 5,33,86,24,26,50,136
1636,18,"K&K 2,3,4,6",6,"K&K 2,3",15,K&K 4,15,K&K 6,3,"A.P F 3,4",7,A.P F 5,58,76,21,18,39,115
1637,21,"K&K 2,3,4,6",12,"K&K 2,3",8,K&K 4,4,K&K 6,4,"A.P F 3,4",6,A.P F 5,39,60,15,14,29,89
1638,10,"K&K 2,3,4,6",11,"K&K 2,3",5,K&K 4,11,K&K 6,14,"A.P F 3,4",8,A.P F 5,59,69,,,0,69
1639,16,"K&K 2,3,4,6",6,"K&K 2,3",3,K&K 4,11,K&K 6,13,"A.P F 3,4",8,A.P F 5,49,65,14,18,32,97
1640,20,"K&K 2,3,4,6",9,"K&K 2,3",12,K&K 4,10,K&K 6,8,"A.P F 3,4",5,A.P F 5,52,72,22,22,44,116
1641,4,"K&K 2,3,4,6",1,"K&K 2,3",0,K&K 4,0,K&K 6,2,"A.P F 3,4",0,A.P F 5,3,7,6,4,10,17
1642,9,"K&K 2,3,4,6",15,"K&K 2,3",12,K&K 4,11,K&K 6,14,"A.P F 3,4",12,A.P F 5,71,80,20,18,38,118
1643,19,"K&K 2,3,4,6",3,"K&K 2,3",2,K&K 4,11,K&K 6,3,"A.P F 3,4",8,A.P F 5,33,52,6,8,14,66
1644,24,"K&K 2,3,4,6",9,"K&K 2,3",9,K&K 4,11,K&K 6,12,"A.P F 3,4",1,A.P F 5,55,79,33,20,53,132
1645,10,"K&K 2,3,4,6",8,"K&K 2,3",4,K&K 4,4,K&K 6,11,"A.P F 3,4",5,A.P F 5,35,45,17,14,31,76
1646,26,"K&K 2,3,4,6",11,"K&K 2,3",8,K&K 4,9,K&K 6,15,"A.P F 3,4",12,A.P F 5,63,89,18,13,31,120
1647,16,"K&K 2,3,4,6",5,"K&K 2,3",5,K&K 4,15,K&K 6,11,"A.P F 3,4",3,A.P F 5,47,63,8,13,21,84
1648,7,"K&K 2,3,4,6",6,"K&K 2,3",8,K&K 4,4,K&K 6,4,"A.P F 3,4",1,A.P F 5,28,35,3,7,10,45
1649,24,"K&K 2,3,4,6",11,"K&K 2,3",11,K&K 4,11,K&K 6,13,"A.P F 3,4",6,A.P F 5,61,85,29,23,52,137
1650,19,"K&K 2,3,4,6",8,"K&K 2,3",8,K&K 4,0,K&K 6,15,"A.P F 3,4",10,A.P F 5,53,72,25,12,37,109
1651,15,"K&K 2,3,4,6",5,"K&K 2,3",9,K&K 4,13,K&K 6,0,"A.P F 3,4",5,A.P F 5,41,56,9,5,14,70
1652,30,"K&K 2,3,4,6",9,"K&K 2,3",11,K&K 4,14,K&K 6,11,"A.P F 3,4",15,A.P F 5,67,97,16,26,42,139
1653,29,"K&K 2,3,4,6",12,"K&K 2,3",6,K&K 4,11,K&K 6,15,"A.P F 3,4",2,A.P F 5,59,88,24,14,38,126
1654,16,"K&K 2,3,4,6",4,"K&K 2,3",0,K&K 4,0,K&K 6,0,"A.P F 3,4",0,A.P F 5,5,21,5,10,15,36
1655,4,"K&K 2,3,4,6",2,"K&K 2,3",3,K&K 4,2,K&K 6,5,"A.P F 3,4",2,A.P F 5,16,20,9,11,20,40
1656,4,"K&K 2,3,4,6",0,"K&K 2,3",3,K&K 4,2,K&K 6,0,"A.P F 3,4",0,A.P F 5,6,10,0,3,3,13
1657,0,"K&K 2,3,4,6",1,"K&K 2,3",1,K&K 4,1,K&K 6,1,"A.P F 3,4",0,A.P F 5,4,4,0,0,0,4
1658,22,"K&K 2,3,4,6",11,"K&K 2,3",11,K&K 4,14,K&K 6,15,"A.P F 3,4",7,A.P F 5,68,90,33,29,62,152
